x,y,ACCOMMODATION UNITS (ROOMS APARTMENTS CAMPING SITES) - TOTAL,A_AUSTRIAN TOURISTS,A_DOMESTIC TOURISTS - TOTAL,A_FOREIGN TOURISTS - TOTAL,A_GERMAN TOURISTS,A_ITALIAN TOURISTS,A_SLOVENIAN TOURISTS,ESTABLISHMENTS - TOTAL,NUMBER OF PERMANENT BEDS,N_AUSTRIAN TOURISTS,N_DOMESTIC TOURISTS - TOTAL,N_FOREIGN TOURISTS - TOTAL,N_GERMAN TOURISTS,N_ITALIAN TOURISTS,N_SLOVENIAN TOURISTS,TOTAL ARRIVALS,TOTAL NIGHTS
0,99,12664,94397,43461,530809,123547,70692,43503,2053,33669,508588,124977,3210716,1067151,339652,160707,574270,3335693
0,100,1,0,0,0,0,0,0,1,4,0,0,0,0,0,0,0,0
0,102,165,147,24,1375,760,59,18,96,503,932,82,11719,7162,352,104,1399,11801
0,103,236,639,297,6487,2585,880,318,119,717,3876,801,44997,24259,3412,1005,6784,45798
0,104,124,87,84,1064,640,57,50,60,387,561,308,9095,6152,359,194,1148,9403
0,105,107,162,46,1834,1072,169,53,56,315,1115,195,16347,10814,1092,197,1880,16542
0,106,292,0,0,0,0,0,0,128,733,0,0,0,0,0,0,0,0
0,107,6,0,0,0,0,0,0,3,15,0,0,0,0,0,0,0,0
0,108,66,248,36,1371,382,113,25,23,160,1101,105,8591,3632,232,44,1407,8696
0,109,125,243,95,1909,915,115,81,51,335,1359,311,13992,8650,392,214,2004,14303
0,110,18,0,0,100,78,0,0,6,36,0,0,935,737,0,0,100,935
1,98,15,0,0,0,0,0,0,4,36,0,0,0,0,0,0,0,0
1,99,63,36,0,216,127,0,0,13,174,254,0,1766,1123,0,0,216,1766
1,100,274,777,363,7196,2178,1282,157,115,712,4724,1502,45575,18850,5974,532,7559,47077
1,101,41,9,12,175,109,3,7,15,91,61,84,1655,1089,12,79,187,1739
1,102,139,116,48,787,295,36,28,58,336,626,73,6067,2907,361,89,835,6140
1,103,55,53,37,566,248,74,26,30,161,358,76,4238,2436,185,101,603,4314
1,104,64,17,16,495,239,33,15,19,171,103,21,3799,2427,116,42,511,3820
1,105,270,425,224,3075,973,172,145,91,591,2456,611,21063,8803,732,341,3299,21674
1,106,102,0,0,0,0,0,0,39,249,0,0,0,0,0,0,0,0
1,107,74,68,14,513,163,0,1,29,171,410,50,4108,1416,0,7,527,4158
1,108,104,356,311,2060,338,295,228,33,269,1145,1344,8598,2142,713,656,2371,9942
1,109,11,27,23,190,31,36,15,6,22,83,33,763,279,73,29,213,796
2,96,5,0,0,0,0,0,0,2,16,0,0,0,0,0,0,0,0
2,97,145,338,99,3286,1433,295,269,68,419,2380,540,26556,14412,1834,1466,3385,27096
2,98,16,62,30,470,108,168,28,9,36,356,93,2711,987,710,115,500,2804
2,99,802,5626,1804,44435,12181,7406,11525,87,2249,33734,5716,281967,104357,37267,69025,46239,287683
2,100,172,204,296,2745,1116,344,77,69,399,1204,766,18357,9758,1277,128,3041,19123
2,101,70,44,7,254,156,14,0,29,154,295,47,2383,1634,68,0,261,2430
2,102,122,154,3,1176,626,36,0,49,292,1225,8,10476,5917,281,0,1179,10484
2,103,313,490,74,3375,1784,59,22,115,713,3407,331,29751,17192,389,100,3449,30082
2,104,80,24,4,249,148,0,4,30,185,211,28,2391,1414,0,28,253,2419
2,105,103,171,14,1131,664,42,21,40,247,1373,53,9545,5780,275,101,1145,9598
2,106,49,49,32,674,324,18,5,24,130,326,129,5510,3278,88,13,706,5639
2,107,91,59,167,1116,317,118,81,37,205,321,324,6820,2684,202,137,1283,7144
2,108,30,72,9,258,130,0,2,13,69,482,65,2023,1151,0,8,267,2088
2,109,2,0,0,0,0,0,0,1,4,0,0,0,0,0,0,0,0
3,94,62,287,143,1897,489,241,50,34,155,2026,604,13520,4167,1710,330,2040,14124
3,95,3865,7952,7323,128338,38197,14591,19428,739,11273,52202,42804,961678,336453,93262,108682,135661,1004482
3,96,618,838,1586,17681,4013,831,5865,227,1836,5344,6694,116462,38935,4148,38584,19267,123156
3,97,5,0,0,0,0,0,0,4,20,0,0,0,0,0,0,0,0
3,98,78,336,59,1908,1154,43,18,29,203,2393,180,17233,11599,336,31,1967,17413
3,100,99,104,5,918,657,24,2,39,232,741,32,8652,6825,170,8,923,8684
3,101,101,117,66,1670,813,99,47,41,226,930,277,13476,8118,505,315,1736,13753
3,102,108,186,46,1961,954,16,8,40,240,1582,197,17908,9360,61,68,2007,18105
3,103,106,203,61,1996,1126,39,7,37,283,1665,205,18466,11453,137,49,2057,18671
3,104,40,82,99,806,371,55,6,20,125,635,221,6699,3969,205,14,905,6920
3,105,20,20,25,384,211,9,0,14,76,216,131,3850,2220,67,0,409,3981
3,106,55,58,14,676,372,0,0,19,115,456,86,6576,3674,0,0,690,6662
3,107,791,394,291,4130,1117,341,213,66,1826,852,566,9494,2877,506,408,4421,10060
3,108,54,108,71,626,189,14,58,18,118,345,119,3529,1672,18,87,697,3648
4,92,60,147,4,1377,678,142,54,24,189,1045,18,12140,7038,1064,394,1381,12158
4,93,2865,7214,3728,76206,22180,6796,6573,701,7928,43073,13641,528273,192719,39468,45125,79934,541914
4,94,8016,25135,36963,330339,62600,39082,21508,2191,21808,120207,95112,1689040,420845,180211,93214,367302,1784152
4,95,310,501,372,8249,2605,1101,246,163,872,3485,1385,57816,24588,6499,994,8621,59201
4,96,306,666,375,7770,2841,530,1200,167,898,4644,2194,63394,27721,3825,7791,8145,65588
4,97,13,0,0,0,0,0,0,4,26,0,0,0,0,0,0,0,0
4,98,314,499,47,3828,2452,25,55,92,655,3692,329,36554,25648,162,285,3875,36883
4,99,77,100,20,914,493,6,20,29,166,723,63,8266,4952,20,73,934,8329
4,100,122,111,114,1485,728,25,38,49,260,822,296,12734,7001,104,119,1599,13030
4,101,133,119,33,1686,1012,49,31,47,322,978,113,16021,10762,292,141,1719,16134
4,102,61,12,34,458,252,12,0,27,145,121,134,3997,2452,51,0,492,4131
4,103,116,197,57,1868,1152,17,29,50,274,1576,389,18625,12364,86,125,1925,19014
4,104,53,43,51,651,353,25,6,21,143,370,147,5668,3581,127,21,702,5815
4,105,37,48,149,759,280,43,32,13,84,127,277,3471,1680,98,46,908,3748
4,106,7,0,0,0,0,0,0,3,16,0,0,0,0,0,0,0,0
4,107,23,0,0,0,0,0,0,9,47,0,0,0,0,0,0,0,0
4,108,8,0,0,0,0,0,0,3,16,0,0,0,0,0,0,0,0
4,109,8,0,0,0,0,0,0,4,20,0,0,0,0,0,0,0,0
5,92,2881,13626,1239,92475,16715,18473,23172,464,8272,78533,6395,547082,124823,94508,127645,93714,553477
5,93,693,2061,210,17279,5616,1607,3069,207,1973,13771,1586,120526,47736,9665,19024,17489,122112
5,94,104,228,53,2619,1103,235,38,66,301,1709,239,20383,10554,1326,199,2672,20622
5,95,137,310,69,2926,1662,133,8,66,368,2362,282,26060,16852,912,37,2995,26342
5,96,3,0,0,0,0,0,0,3,10,0,0,0,0,0,0,0,0
5,97,55,80,29,826,379,49,5,20,130,510,77,6908,4096,201,34,855,6985
5,98,136,176,24,2071,1304,59,35,48,290,1368,138,20224,13624,417,227,2095,20362
5,99,69,49,0,420,234,33,2,26,161,399,0,3713,2344,209,14,420,3713
5,100,60,75,58,1042,586,46,8,25,130,620,158,9572,6243,309,14,1100,9730
5,101,79,115,34,894,484,14,4,27,179,907,169,8281,5006,59,20,928,8450
5,102,65,39,45,1045,677,40,17,29,185,299,209,10034,6943,165,104,1090,10243
5,103,36,79,21,631,363,11,4,17,101,583,66,5601,3597,77,8,652,5667
5,104,86,164,2411,2379,448,490,115,27,204,658,4689,10927,2829,1052,169,4790,15616
5,105,7,0,0,0,0,0,0,3,14,0,0,0,0,0,0,0,0
5,106,4,0,0,0,0,0,0,3,9,0,0,0,0,0,0,0,0
5,107,9,0,0,0,0,0,0,3,21,0,0,0,0,0,0,0,0
5,108,35,0,0,0,0,0,0,13,74,0,0,0,0,0,0,0,0
5,109,123,705,1763,6194,838,589,338,29,251,2018,3542,19197,3991,1067,451,7957,22739
5,110,5,0,0,0,0,0,0,2,12,0,0,0,0,0,0,0,0
6,92,2455,19809,3829,90645,20190,10021,9984,252,6333,106845,13851,566186,157099,53806,50398,94474,580037
6,93,4085,14421,2492,100004,38525,12622,5895,1033,11528,99026,12191,770812,360430,82452,31341,102496,783003
6,94,201,616,396,5192,2574,608,140,84,491,3917,769,40500,24740,3190,538,5588,41269
6,95,194,476,54,3760,1969,275,32,85,459,3526,342,32919,20240,1620,121,3814,33261
6,96,127,124,24,2131,1374,135,28,58,311,868,124,20077,14456,874,73,2155,20201
6,97,18,0,0,0,0,0,0,8,37,0,0,0,0,0,0,0,0
6,98,156,395,138,2696,1411,145,27,63,386,2485,488,21533,13520,775,91,2834,22021
6,99,105,267,255,2317,1416,54,70,45,245,1771,396,21798,14904,316,190,2572,22194
6,100,96,165,19,934,359,57,51,30,208,1040,142,7311,3082,286,145,953,7453
6,101,47,0,0,104,75,11,0,17,105,0,0,989,830,54,0,104,989
6,102,10,0,0,0,0,0,0,6,31,0,0,0,0,0,0,0,0
6,103,6,0,0,0,0,0,0,2,12,0,0,0,0,0,0,0,0
6,104,14,7,132,167,43,29,2,8,33,40,588,1042,318,243,2,299,1630
6,105,20,0,0,0,0,0,0,7,52,0,0,0,0,0,0,0,0
6,106,5,0,0,0,0,0,0,2,12,0,0,0,0,0,0,0,0
6,107,10,0,0,0,0,0,0,7,28,0,0,0,0,0,0,0,0
6,108,33,0,0,75,38,0,0,16,64,0,0,602,364,0,0,75,602
6,109,29,0,0,0,0,0,0,12,61,0,0,0,0,0,0,0,0
7,95,94,187,63,1875,1079,65,36,37,218,1156,409,16568,10784,419,137,1938,16977
7,96,253,411,145,4457,2487,222,106,108,614,2967,955,40223,25590,1515,794,4602,41178
7,97,532,569,3357,10026,1764,976,2455,99,1549,2964,18966,65359,16161,5711,14782,13383,84325
7,98,171,386,49,3280,2151,71,21,76,385,2996,102,31343,22069,407,105,3329,31445
7,99,51,158,36,1101,482,33,34,21,108,823,86,7607,4522,131,82,1137,7693
7,100,76,63,9,1068,721,28,9,33,179,564,66,10396,7640,132,58,1077,10462
7,101,41,45,12,499,288,14,18,20,109,407,112,4696,3020,58,38,511,4808
7,102,10,0,0,0,0,0,0,6,28,0,0,0,0,0,0,0,0
7,103,73,162,70,1324,813,13,8,35,185,834,270,11473,8058,71,38,1394,11743
7,104,29,24,78,450,112,78,20,12,67,104,178,2226,889,257,32,528,2404
7,105,1,0,0,0,0,0,0,1,4,0,0,0,0,0,0,0,0
7,106,13,0,0,0,0,0,0,6,35,0,0,0,0,0,0,0,0
7,107,12,73,104,812,160,84,22,9,28,193,178,1969,620,130,46,916,2147
7,108,12,0,0,0,0,0,0,5,24,0,0,0,0,0,0,0,0
7,109,48,0,0,0,0,0,0,29,112,0,0,0,0,0,0,0,0
7,110,4,0,0,0,0,0,0,2,9,0,0,0,0,0,0,0,0
8,96,2,0,0,0,0,0,0,1,6,0,0,0,0,0,0,0,0
8,97,191,452,17,4317,2549,363,42,82,452,3268,106,39325,26181,2291,276,4334,39431
8,98,56,208,40,1237,628,32,5,30,148,1444,154,10317,6152,220,23,1277,10471
8,99,89,117,58,1613,1134,52,7,43,234,830,209,15761,12202,356,43,1671,15970
8,100,248,339,133,4322,2710,192,56,121,650,2215,569,41627,29014,1387,294,4455,42196
8,101,74,159,42,1534,800,138,47,45,210,957,158,12378,7981,655,133,1576,12536
8,102,135,266,44,2580,1553,47,68,56,345,1824,116,23587,15846,391,231,2624,23703
8,103,30,0,0,0,0,0,0,16,90,0,0,0,0,0,0,0,0
8,104,27,116,19,655,222,29,40,13,72,523,49,3980,2054,64,70,674,4029
8,106,13,0,0,0,0,0,0,5,28,0,0,0,0,0,0,0,0
8,107,4,0,0,0,0,0,0,3,17,0,0,0,0,0,0,0,0
8,108,14,49,56,506,27,187,41,9,36,217,153,1574,137,361,86,562,1727
8,109,11,0,0,0,0,0,0,4,24,0,0,0,0,0,0,0,0
8,110,1,0,0,0,0,0,0,1,3,0,0,0,0,0,0,0,0
9,97,284,126,37,986,440,80,13,55,782,836,196,8201,4142,657,90,1023,8397
9,98,35,53,19,582,259,67,7,14,100,324,80,4203,2263,354,24,601,4283
9,99,50,139,12,938,622,25,11,28,139,1121,58,8497,6076,188,71,950,8555
9,100,314,591,242,7761,3542,794,205,167,845,3728,1033,60424,34999,3907,803,8003,61457
9,101,270,732,848,7559,3187,1153,158,147,760,4036,2907,49474,29607,3600,350,8407,52381
9,102,111,90,41,1191,730,47,28,49,312,645,255,11582,8025,290,129,1232,11837
9,103,85,100,53,1078,521,46,13,39,211,824,174,9848,5357,271,68,1131,10022
9,104,27,12,17,177,99,2,0,12,62,132,303,1759,1096,14,0,194,2062
9,105,13,19,0,205,128,22,0,5,27,157,0,2000,1460,127,0,205,2000
9,106,14,0,0,0,0,0,0,5,32,0,0,0,0,0,0,0,0
9,107,22,0,0,0,0,0,0,8,47,0,0,0,0,0,0,0,0
9,110,3,0,0,0,0,0,0,1,6,0,0,0,0,0,0,0,0
10,97,6,0,0,0,0,0,0,2,12,0,0,0,0,0,0,0,0
10,98,289,964,129,6624,2957,419,190,123,702,6077,577,50945,28156,2193,1026,6753,51522
10,99,437,0,0,0,0,0,0,57,1296,0,0,0,0,0,0,0,0
10,100,3601,34587,7959,178818,46893,15376,15139,427,8530,175828,23256,1111637,366929,72241,57245,186777,1134893
10,101,102,326,21,2234,1386,85,14,42,242,2346,82,18836,12704,319,82,2255,18918
10,102,79,188,279,1617,434,380,40,31,211,523,848,5721,1794,1108,57,1896,6569
10,103,34,54,4,445,209,26,10,13,73,292,45,4217,2357,124,63,449,4262
10,104,6,0,0,0,0,0,0,2,12,0,0,0,0,0,0,0,0
10,105,4,0,0,0,0,0,0,1,8,0,0,0,0,0,0,0,0
10,106,9,0,0,0,0,0,0,1,18,0,0,0,0,0,0,0,0
11,101,32,13,2,528,339,29,6,15,89,77,14,4574,3442,93,42,530,4588
11,102,31,66,6,577,286,29,0,14,78,437,55,4423,2737,95,0,583,4478
11,103,143,356,40,3425,911,465,101,58,365,1719,99,21037,7582,1912,413,3465,21136
11,104,494,6593,1276,24831,4399,3360,1914,119,1070,28636,3688,111029,29957,12811,7080,26107,114717
11,105,543,3229,465,21010,5241,2761,2393,162,1451,15306,2115,104747,30480,12828,10771,21475,106862
11,106,105,110,117,973,350,86,21,59,305,634,905,6325,3214,526,45,1090,7230
11,107,35,60,30,566,161,38,11,20,105,277,57,3036,1218,96,23,596,3093
11,109,6,16,6,189,57,27,0,5,19,59,16,930,444,87,0,195,946
11,110,21,101,58,444,158,25,14,7,48,303,148,3274,1431,64,63,502,3422
11,111,7,0,0,0,0,0,0,4,15,0,0,0,0,0,0,0,0
11,112,3,0,0,0,0,0,0,3,8,0,0,0,0,0,0,0,0
12,88,70,0,0,0,0,0,0,34,190,0,0,0,0,0,0,0,0
12,101,3,0,0,0,0,0,0,2,8,0,0,0,0,0,0,0,0
12,102,15,54,23,387,124,35,26,11,42,355,181,3186,1185,285,247,410,3367
12,105,399,1192,618,15977,3585,1339,2730,36,1162,4935,2467,63489,16797,4910,11251,16595,65956
12,106,1367,10481,13512,76194,13670,7660,5610,356,3270,42949,34757,302069,80439,27640,14889,89706,336826
12,107,2581,30646,14607,141686,23325,13953,8146,482,5691,118667,37563,518255,117222,39254,20220,156293,555818
12,108,2067,28341,38796,178226,18802,20279,12056,479,4448,95861,84429,547021,93423,49680,25677,217022,631450
12,109,31,39,73,432,55,120,21,15,73,141,151,1381,268,314,27,505,1532
12,110,3,0,0,0,0,0,0,2,6,0,0,0,0,0,0,0,0
12,111,23,0,0,0,0,0,0,8,58,0,0,0,0,0,0,0,0
13,84,42,281,162,763,80,77,165,27,126,2548,874,6124,810,536,1104,925,6998
13,95,4,0,0,0,0,0,0,4,13,0,0,0,0,0,0,0,0
13,96,1,0,0,0,0,0,0,1,2,0,0,0,0,0,0,0,0
13,101,10,0,0,0,0,0,0,3,28,0,0,0,0,0,0,0,0
13,102,1,0,0,0,0,0,0,1,4,0,0,0,0,0,0,0,0
13,107,1,0,0,0,0,0,0,1,4,0,0,0,0,0,0,0,0
13,108,362,756,2134,13861,2615,3430,327,224,1009,3006,6737,61652,19729,8868,1067,15995,68389
13,109,24,37,10,406,172,13,12,10,57,247,19,3144,1735,108,16,416,3163
13,110,1,0,0,0,0,0,0,1,2,0,0,0,0,0,0,0,0
13,111,2,0,0,0,0,0,0,1,4,0,0,0,0,0,0,0,0
14,84,16,212,63,433,47,37,55,9,51,1897,416,3711,394,331,424,496,4127
14,92,11,9,6,177,28,58,10,7,32,47,28,1201,302,421,52,183,1229
14,93,865,493,213,4447,496,1072,1841,158,2505,4089,1537,35518,4591,8017,14659,4660,37055
14,95,190,1445,126,5606,1498,1158,352,52,520,9295,519,36715,11094,7727,2372,5732,37234
14,97,10,8,1,101,15,7,43,10,21,50,10,1048,161,34,495,102,1058
14,101,72,0,0,0,0,0,0,9,203,0,0,0,0,0,0,0,0
14,107,310,189,663,4146,397,1006,161,62,764,681,2571,14181,1878,2946,457,4809,16752
14,108,108,193,542,4341,780,769,76,90,301,631,2140,18565,5391,2375,188,4883,20705
14,109,41,63,451,875,295,190,34,21,110,392,1011,5797,2781,1290,76,1326,6808
15,86,212,393,357,4429,772,1231,1029,95,600,3350,2808,38300,8226,10352,8438,4786,41108
15,87,42,105,54,963,155,335,136,28,121,760,255,7093,1380,2073,1175,1017,7348
15,88,53,107,84,1325,178,150,517,30,174,866,560,11096,1739,1069,4402,1409,11656
15,89,1187,1875,1251,39347,6751,3532,22397,111,3721,12889,6606,302142,57813,25174,177674,40598,308748
15,90,503,1273,373,14101,5351,1397,2836,18,1500,8781,2310,97571,39721,9887,23293,14474,99881
15,91,16,65,4,404,36,173,21,11,54,379,32,2859,236,1229,257,408,2891
15,92,41,166,20,747,167,194,46,24,117,1384,122,5818,1543,1475,341,767,5940
15,94,4,9,19,168,14,69,12,3,10,21,52,503,68,248,34,187,555
15,95,23,49,62,521,38,228,54,14,53,309,310,2782,221,1283,312,583,3092
15,96,10,28,21,264,21,123,17,6,24,187,100,1586,215,636,76,285,1686
15,97,2405,7973,4225,79031,22187,16166,17081,341,6654,56195,23595,581355,209744,98054,128101,83256,604950
15,100,68,83,42,1843,575,255,91,35,176,544,186,12624,5667,1531,656,1885,12810
15,101,344,0,0,0,0,0,0,3,1031,0,0,0,0,0,0,0,0
15,107,905,4489,21644,96111,10056,15711,2135,387,2213,8650,38283,199012,23760,29255,5133,117755,237295
15,108,39,69,418,1960,238,560,39,28,101,233,1252,5711,1158,1296,75,2378,6963
15,109,35,19,42,240,49,68,2,16,86,59,134,944,326,197,4,282,1078
16,85,45,132,192,568,116,101,66,6,101,599,1262,3310,883,465,493,760,4572
16,86,44,45,84,831,113,145,410,12,130,262,569,6469,1198,1159,3281,915,7038
16,91,12,18,7,204,35,53,3,8,32,121,34,1370,290,374,15,211,1404
16,99,229,399,331,6820,1717,929,1414,99,687,2585,2038,48028,16662,5805,7683,7151,50066
16,100,236,532,134,5701,2294,677,371,98,638,3785,686,38716,20844,4007,1531,5835,39402
16,101,374,868,485,9027,2133,1210,1739,182,1101,5755,2704,66486,19191,8566,11282,9512,69190
16,102,299,2316,370,8907,2249,1233,919,80,694,12704,1743,54757,18487,6993,4845,9277,56500
16,106,28,20,20,330,70,30,3,16,90,92,161,2934,627,320,17,350,3095
16,107,249,570,4795,6225,1296,968,189,99,639,2843,13824,33697,10122,3266,448,11020,47521
16,108,88,146,1713,1571,346,341,93,26,254,395,3682,5271,1950,689,428,3284,8953
16,109,26,55,187,629,152,256,5,12,67,142,589,2181,763,625,7,816,2770
17,85,5203,29168,37334,164958,39824,25521,30270,780,13433,176470,171598,1136242,332620,155439,203773,202292,1307840
17,86,41,137,96,1132,291,227,155,19,115,949,427,8541,2813,1549,1033,1228,8968
17,88,508,30,18,316,48,89,97,30,1500,394,106,3102,464,924,862,334,3208
17,99,19,61,16,455,148,88,0,10,48,384,92,3354,1362,452,0,471,3446
17,100,142,457,165,3964,981,891,167,65,403,2522,469,22858,8143,4655,551,4129,23327
17,101,287,32,3,206,124,0,2,146,759,270,21,1945,1169,0,14,209,1966
17,102,2262,11283,11122,78932,21080,8959,8818,869,6005,56410,45186,469195,156455,52108,41630,90054,514381
17,103,1925,10356,5218,90186,30887,5668,20052,326,5013,53414,21537,515052,212636,27377,98802,95404,536589
17,104,435,383,2648,17815,2127,752,1219,64,951,1606,10311,82958,11419,2814,5669,20463,93269
17,105,244,335,2213,5697,1039,429,1798,76,663,2025,12923,35000,8592,2786,9240,7910,47923
17,106,953,664,2683,30532,3103,967,11336,63,2356,2797,13514,122764,13229,2417,47722,33215,136278
17,107,44,62,121,1059,280,124,22,41,120,370,337,5693,2279,536,61,1180,6030
17,110,11,0,0,0,0,0,0,2,39,0,0,0,0,0,0,0,0
17,115,6,0,0,0,0,0,0,2,17,0,0,0,0,0,0,0,0
17,116,1,0,0,0,0,0,0,1,3,0,0,0,0,0,0,0,0
18,83,20,0,0,0,0,0,0,11,64,0,0,0,0,0,0,0,0
18,84,4,0,0,0,0,0,0,3,10,0,0,0,0,0,0,0,0
18,85,4,0,0,0,0,0,0,1,14,0,0,0,0,0,0,0,0
18,99,3622,18358,5817,133895,37949,17781,14811,781,9901,90685,24253,742697,258704,88505,73334,139712,766950
18,100,24,38,41,520,225,94,32,13,57,202,184,3870,2049,524,164,561,4054
18,101,145,245,61,2072,1087,190,13,59,342,1782,355,17711,11077,1209,59,2133,18066
18,102,237,751,282,7015,1866,686,642,98,679,4036,1017,43234,16420,3230,3698,7297,44251
18,103,195,325,199,4417,1352,430,673,87,518,2233,1119,33688,12948,3065,4384,4616,34807
18,104,19,32,50,430,127,11,36,11,53,293,550,3697,1346,81,276,480,4247
18,105,252,520,535,4125,1476,280,244,125,668,3513,2672,29999,13370,1844,1055,4660,32671
18,106,138,194,1161,2820,579,370,138,53,333,893,3135,11296,4036,1102,425,3981,14431
18,107,4,2,0,131,100,0,0,4,12,8,0,1338,1043,0,0,131,1338
18,113,19,0,0,0,0,0,0,3,48,0,0,0,0,0,0,0,0
18,114,19,0,251,45,2,6,9,10,89,0,605,97,3,14,20,296,702
18,115,4,0,0,0,0,0,0,3,12,0,0,0,0,0,0,0,0
19,80,8,17,31,85,6,17,31,5,28,171,242,831,31,160,401,116,1073
19,99,2500,10119,3693,72130,16874,8100,18525,394,7111,56973,18314,427911,118154,42458,110155,75823,446225
19,100,274,765,349,7018,2236,963,742,137,757,4646,1963,48689,20307,5780,4528,7367,50652
19,101,111,281,122,2911,1131,349,163,66,335,1977,699,21822,10734,2406,895,3033,22521
19,102,434,932,383,11144,3407,1366,914,214,1281,6322,1956,82733,32972,9216,5037,11527,84689
19,103,226,1226,187,8896,3288,402,1345,69,670,7781,1257,53573,22302,2218,7735,9083,54830
19,104,1051,1847,4234,29057,7475,1036,3428,349,2900,10700,20584,192710,64727,5801,17909,33291,213294
19,105,165,295,542,3567,1255,193,185,73,440,1936,2799,24825,11345,924,934,4109,27624
19,107,4,3,30,56,14,6,6,4,12,6,64,303,158,16,14,86,367
19,109,3,0,0,0,0,0,0,2,6,0,0,0,0,0,0,0,0
19,113,4,0,0,0,0,0,0,1,8,0,0,0,0,0,0,0,0
19,114,3,0,0,0,0,0,0,2,8,0,0,0,0,0,0,0,0
20,80,14,19,34,152,17,44,44,9,42,152,211,1031,96,283,309,186,1242
20,97,516,326,27,2465,432,386,98,64,1454,2079,168,16914,3330,2518,754,2492,17082
20,100,227,940,258,7404,2900,652,244,112,615,5002,959,49619,24734,3286,1229,7662,50578
20,101,114,889,438,5523,1403,532,971,49,299,3748,1103,24877,9716,2022,2252,5961,25980
20,102,630,1164,314,15570,4362,1261,4146,135,1858,7638,1741,105270,39257,7056,22743,15884,107011
20,103,3690,17328,26005,124815,33674,5499,10403,1240,9998,77493,104805,703499,249115,21567,43805,150820,808304
20,104,1773,7936,10344,49529,9894,1135,2926,395,4213,36718,56496,290176,84368,5106,12753,59873,346672
20,105,42,161,98,961,332,41,101,18,107,771,378,5586,2680,193,365,1059,5964
20,106,20,0,219,213,53,14,11,11,54,0,491,1030,436,42,14,432,1521
20,107,141,126,4843,4580,352,302,119,49,334,327,12114,11284,2215,621,275,9423,23398
20,108,9,13,175,455,118,23,5,4,26,28,527,1158,384,35,7,630,1685
20,109,5,0,0,0,0,0,0,3,11,0,0,0,0,0,0,0,0
20,110,40,10,756,662,117,85,13,23,101,14,1698,1531,361,135,29,1418,3229
20,113,1,0,0,0,0,0,0,1,4,0,0,0,0,0,0,0,0
21,81,144,352,820,1742,193,262,531,90,426,3834,6412,16091,1910,2167,5316,2562,22503
21,92,546,945,543,8116,2225,997,687,107,1467,7174,3431,64864,21682,7965,4986,8659,68295
21,93,1501,4701,1601,34887,12436,2678,2971,449,4310,33425,10019,281177,125335,19839,20923,36488,291196
21,94,832,1845,844,21371,8694,1089,974,270,2609,11842,5222,166318,78653,8243,6687,22215,171540
21,97,401,2669,415,14047,2610,1096,835,156,1033,15299,2099,89869,20668,5634,4487,14462,91968
21,98,754,2683,1224,25777,4820,3926,1539,308,2079,15125,5416,157296,38479,21649,7377,27001,162712
21,103,2433,9887,14168,88148,18819,4108,17848,487,6573,38850,73484,432234,108376,13953,81478,102316,505718
21,104,40,25,36,644,396,30,0,28,136,136,230,5924,4162,216,0,680,6154
21,107,11,0,0,0,0,0,0,5,34,0,0,0,0,0,0,0,0
21,108,19,5,251,95,2,15,5,11,46,5,496,237,4,15,7,346,733
21,113,1,0,0,0,0,0,0,1,6,0,0,0,0,0,0,0,0
22,81,24,35,183,266,24,29,120,16,70,340,1411,2389,248,208,1154,449,3800
22,89,25,28,18,294,24,64,51,10,74,248,113,2259,217,464,376,312,2372
22,90,356,1284,2319,9754,1356,1335,1680,82,894,7146,8023,60168,11107,8789,10249,12073,68191
22,92,3344,13652,9274,88718,29981,10671,7524,793,8859,77087,39417,588470,241630,67782,48077,97992,627887
22,93,33,63,62,905,319,95,16,15,111,505,370,7593,3228,696,90,967,7963
22,94,2389,11050,2545,66849,24446,3040,4711,189,6844,75509,15022,519722,227406,21248,35633,69394,534744
22,98,2647,23508,7017,123122,26770,12490,16886,461,7193,122048,25709,712856,189954,67837,79356,130139,738565
22,102,2127,3710,12609,45688,9953,2283,3003,679,6424,17147,56577,300120,86849,12951,13133,58297,356697
22,103,48,49,20,752,407,45,4,32,136,305,158,6622,3789,360,4,772,6780
22,104,2,0,0,0,0,0,0,1,4,0,0,0,0,0,0,0,0
22,107,3,0,0,0,0,0,0,2,8,0,0,0,0,0,0,0,0
22,108,8,0,0,0,0,0,0,3,21,0,0,0,0,0,0,0,0
22,109,57,81,2516,3693,148,317,72,14,152,119,5316,5117,225,464,103,6209,10433
22,110,33,32,730,615,59,104,66,14,106,119,1487,1172,80,121,171,1345,2659
22,111,7,0,0,0,0,0,0,3,16,0,0,0,0,0,0,0,0
22,112,6,0,0,0,0,0,0,4,18,0,0,0,0,0,0,0,0
23,78,38,27,64,415,46,60,168,22,118,210,531,3620,463,508,1674,479,4151
23,81,25,13,42,151,8,26,69,16,71,175,474,1584,36,319,656,193,2058
23,88,228,0,0,0,0,0,0,57,608,0,0,0,0,0,0,0,0
23,91,1223,3407,1330,23813,10156,2258,1923,464,3544,24802,8864,204683,106776,17801,14312,25143,213547
23,92,262,732,329,5511,2173,506,509,112,816,4678,2139,45499,22311,3936,3863,5840,47638
23,101,893,1491,668,24601,7417,2315,1822,107,2614,7049,2829,117646,37805,9247,8171,25269,120475
23,102,520,923,779,12928,4070,1037,890,163,1461,5166,3038,78645,31633,4226,4078,13707,81683
23,103,2,0,0,0,0,0,0,1,4,0,0,0,0,0,0,0,0
23,104,1,0,0,0,0,0,0,1,4,0,0,0,0,0,0,0,0
23,107,34,2,392,130,5,8,40,11,94,12,766,392,20,14,77,522,1158
23,108,11,8,308,26,4,0,3,7,32,24,684,90,28,0,8,334,774
23,109,1,0,0,0,0,0,0,1,3,0,0,0,0,0,0,0,0
23,110,5,0,0,0,0,0,0,1,10,0,0,0,0,0,0,0,0
23,111,26,0,0,0,0,0,0,10,59,0,0,0,0,0,0,0,0
23,112,8,0,100,60,11,4,0,5,20,0,328,437,75,19,0,160,765
24,75,2,0,0,0,0,0,0,1,6,0,0,0,0,0,0,0,0
24,77,18,37,44,304,29,25,131,13,57,358,348,2863,260,348,1378,348,3211
24,78,3,0,0,0,0,0,0,1,12,0,0,0,0,0,0,0,0
24,93,32,111,16,759,210,51,45,19,110,722,70,5811,1898,361,340,775,5881
24,94,43,0,0,0,0,0,0,24,144,0,0,0,0,0,0,0,0
24,98,998,2589,1124,43864,10394,4487,918,501,2894,8765,3506,189137,62224,15114,3580,44988,192643
24,99,129,186,16,2625,916,201,81,44,390,1054,43,15754,6974,947,356,2641,15797
24,100,123,85,35,1780,448,267,94,15,350,523,210,9788,2890,1284,480,1815,9998
24,102,5,8,0,73,44,0,0,3,12,53,0,706,500,0,0,73,706
24,104,13,0,0,0,0,0,0,5,25,0,0,0,0,0,0,0,0
24,107,28,7,410,106,17,16,6,11,65,8,1094,485,168,33,9,516,1579
24,109,4,0,0,0,0,0,0,2,9,0,0,0,0,0,0,0,0
24,110,5,0,0,0,0,0,0,2,9,0,0,0,0,0,0,0,0
24,111,13,0,0,0,0,0,0,6,57,0,0,0,0,0,0,0,0
24,112,10,0,0,0,0,0,0,6,22,0,0,0,0,0,0,0,0
24,113,5,0,0,0,0,0,0,2,10,0,0,0,0,0,0,0,0
25,75,178,698,845,6652,2130,930,897,49,546,4534,5499,45664,15216,6215,7793,7497,51163
25,77,34,36,34,245,22,13,99,19,100,433,314,2340,255,117,1015,279,2654
25,86,2742,2276,1431,22061,2885,3780,3071,445,7981,8825,7462,112988,15562,21010,21496,23492,120450
25,87,3378,8145,3609,99617,22954,23149,5222,1246,9443,38401,18012,576931,137373,145373,34503,103226,594943
25,88,20,20,21,680,30,13,82,9,60,146,227,5331,327,112,768,701,5558
25,90,2,0,0,0,0,0,0,2,4,0,0,0,0,0,0,0,0
25,91,119,80,52,997,180,61,370,66,347,496,234,7474,1650,304,2680,1049,7708
25,93,5,0,0,0,0,0,0,2,12,0,0,0,0,0,0,0,0
25,95,70,308,63,1650,220,168,65,36,214,2101,260,10838,1529,1204,354,1713,11098
25,97,477,1003,664,18419,5435,1209,670,149,1417,4270,1575,83997,30523,4789,3109,19083,85572
25,98,38,88,37,1607,273,170,36,19,104,239,146,5730,1336,540,140,1644,5876
25,99,10,3,4,129,83,7,6,8,34,21,8,1011,697,32,36,133,1019
25,100,1,0,0,0,0,0,0,1,6,0,0,0,0,0,0,0,0
25,101,1,0,0,0,0,0,0,1,2,0,0,0,0,0,0,0,0
25,109,68,77,1666,3113,219,576,41,17,161,116,3777,3774,320,694,92,4779,7551
25,110,3,0,0,0,0,0,0,2,8,0,0,0,0,0,0,0,0
25,112,1,0,0,0,0,0,0,1,4,0,0,0,0,0,0,0,0
26,75,253,892,2243,4931,763,398,1669,48,591,5703,14530,32058,5512,2506,11035,7174,46588
26,76,5,3,4,55,9,9,17,3,14,51,42,873,261,93,160,59,915
26,84,2188,651,1247,18314,1750,1867,3719,320,6405,4818,9223,150166,17470,14809,31408,19561,159389
26,85,72,160,113,2250,404,351,671,17,195,1080,645,12483,2081,1682,4289,2363,13128
26,86,468,428,348,8422,850,915,3137,129,1246,2154,2235,58477,7828,5552,24477,8770,60712
26,88,38,76,10,916,273,52,35,14,116,472,61,7400,2908,383,420,926,7461
26,95,4,0,0,0,0,0,0,2,12,0,0,0,0,0,0,0,0
26,96,2,0,0,0,0,0,0,2,10,0,0,0,0,0,0,0,0
26,97,3,0,0,0,0,0,0,2,10,0,0,0,0,0,0,0,0
26,98,11,0,0,0,0,0,0,3,22,0,0,0,0,0,0,0,0
26,100,1,0,0,0,0,0,0,1,5,0,0,0,0,0,0,0,0
26,106,22,3,113,64,25,28,4,8,43,8,445,381,284,55,21,177,826
26,109,18,0,0,0,0,0,0,4,118,0,0,0,0,0,0,0,0
26,110,5,0,0,0,0,0,0,3,13,0,0,0,0,0,0,0,0
26,111,6,0,0,0,0,0,0,2,12,0,0,0,0,0,0,0,0
27,74,15,0,0,0,0,0,0,9,46,0,0,0,0,0,0,0,0
27,84,81,167,26,1096,156,256,157,25,231,1121,128,8704,1438,2278,1160,1122,8832
27,85,18,0,0,0,0,0,0,5,44,0,0,0,0,0,0,0,0
27,86,200,102,198,3201,266,433,1017,53,492,575,1126,21223,2159,2821,7104,3399,22349
27,97,2,0,0,0,0,0,0,1,5,0,0,0,0,0,0,0,0
27,104,2,0,0,0,0,0,0,1,6,0,0,0,0,0,0,0,0
27,105,6,0,32,21,4,6,0,4,19,0,86,91,20,12,0,53,177
27,109,17,0,0,0,0,0,0,5,47,0,0,0,0,0,0,0,0
27,110,4,0,0,0,0,0,0,2,8,0,0,0,0,0,0,0,0
27,112,10,0,0,0,0,0,0,5,24,0,0,0,0,0,0,0,0
28,73,57,49,91,616,64,102,115,31,181,424,539,5060,597,677,1078,707,5599
28,75,1,0,0,0,0,0,0,1,2,0,0,0,0,0,0,0,0
28,82,28,0,30,94,14,13,20,10,84,0,195,963,152,110,182,124,1158
28,83,298,275,693,6229,566,707,402,97,776,1745,4323,42454,4857,4735,2727,6922,46777
28,84,1708,3599,4107,43504,4184,7243,4587,534,4712,20570,22541,285430,33189,45315,27135,47611,307971
28,85,337,210,160,4710,533,572,1848,71,837,1435,1038,36357,4397,3992,14401,4870,37395
28,87,432,1067,210,9303,3678,235,255,159,1268,8276,1373,76564,36516,1406,1481,9513,77937
28,94,96,46,1589,1956,211,194,133,14,227,87,2924,3067,396,272,213,3545,5991
28,97,13,0,0,0,0,0,0,2,28,0,0,0,0,0,0,0,0
28,108,3,0,0,0,0,0,0,2,10,0,0,0,0,0,0,0,0
28,111,4,0,0,0,0,0,0,2,8,0,0,0,0,0,0,0,0
29,72,15,4,13,107,9,16,45,8,42,36,130,1116,109,206,506,120,1246
29,73,2,0,0,0,0,0,0,2,12,0,0,0,0,0,0,0,0
29,75,564,377,1540,8425,731,422,3727,166,1739,3037,12693,74060,6773,4480,34719,9965,86753
29,79,147,207,403,3406,487,38,773,55,451,1393,2171,25440,4481,276,5196,3809,27611
29,80,3017,2589,9078,58940,10364,736,8790,1410,9045,20188,62054,467943,106205,5775,68617,68018,529997
29,82,85,99,66,1016,157,76,156,34,246,752,432,8573,1528,498,1272,1082,9005
29,83,13,15,58,323,43,81,13,10,40,201,299,2199,431,541,53,381,2498
29,84,58,29,130,1209,93,311,78,22,167,218,819,8902,738,2112,590,1339,9721
29,86,433,0,0,0,0,0,0,120,1097,0,0,0,0,0,0,0,0
29,94,3,0,0,0,0,0,0,2,9,0,0,0,0,0,0,0,0
29,95,1,0,0,0,0,0,0,1,4,0,0,0,0,0,0,0,0
29,97,1,0,0,0,0,0,0,1,4,0,0,0,0,0,0,0,0
29,99,25,0,0,0,0,0,0,4,32,0,0,0,0,0,0,0,0
29,106,11,0,0,0,0,0,0,4,34,0,0,0,0,0,0,0,0
29,107,2,0,0,0,0,0,0,2,8,0,0,0,0,0,0,0,0
29,108,3,0,0,0,0,0,0,2,8,0,0,0,0,0,0,0,0
29,111,13,0,0,0,0,0,0,4,31,0,0,0,0,0,0,0,0
30,70,12,9,29,175,12,24,62,8,39,104,217,1494,95,188,629,204,1711
30,71,114,93,270,2280,140,162,1010,16,255,488,1267,18550,1104,906,7013,2550,19817
30,73,121,40,68,371,73,17,140,22,325,277,514,3394,810,257,1279,439,3908
30,75,48,39,96,663,80,63,310,27,155,241,765,5314,731,679,2364,759,6079
30,78,245,281,418,4512,1399,48,416,86,735,2598,3049,41741,16354,329,3417,4930,44790
30,79,247,403,458,5392,1022,71,454,96,712,2546,3094,42758,10501,490,3519,5850,45852
30,80,125,70,335,2173,370,53,219,43,395,509,1691,16687,3582,537,1843,2508,18378
30,81,848,915,2070,18416,1847,999,3763,245,2443,6727,14838,137084,16367,5850,29383,20486,151922
30,82,3,0,0,0,0,0,0,1,8,0,0,0,0,0,0,0,0
30,87,1,0,0,0,0,0,0,1,50,0,0,0,0,0,0,0,0
30,89,8,0,0,0,0,0,0,2,15,0,0,0,0,0,0,0,0
30,94,1,0,0,0,0,0,0,1,4,0,0,0,0,0,0,0,0
30,95,1,0,0,0,0,0,0,1,3,0,0,0,0,0,0,0,0
30,105,8,18,121,593,77,66,1,8,34,100,190,1151,147,71,1,714,1341
30,106,55,0,0,0,0,0,0,11,148,0,0,0,0,0,0,0,0
30,107,33,142,1477,5567,282,443,32,7,74,195,2329,6256,393,632,37,7044,8585
30,111,1,0,0,0,0,0,0,1,4,0,0,0,0,0,0,0,0
30,112,1,0,0,0,0,0,0,1,5,0,0,0,0,0,0,0,0
31,69,1,0,0,0,0,0,0,1,2,0,0,0,0,0,0,0,0
31,70,116,211,260,2117,308,300,486,63,375,1912,1575,17223,2925,2381,4519,2377,18798
31,71,4,0,0,0,0,0,0,2,8,0,0,0,0,0,0,0,0
31,72,91,186,175,1658,401,78,603,43,274,1526,1391,15136,4106,641,5807,1833,16527
31,74,105,114,265,1754,275,75,812,62,358,998,2066,16852,2921,556,8247,2019,18918
31,76,1871,17873,12765,97252,18802,3248,5927,314,4796,97154,43452,478843,125876,16218,29619,110017,522295
31,77,51,18,57,987,182,4,23,19,156,153,325,6851,1659,30,219,1044,7176
31,78,5570,13167,14211,146800,42964,4279,7966,820,16648,98728,84467,1198686,424616,31196,55142,161011,1283153
31,79,75,40,137,730,111,11,79,15,210,266,915,5067,1240,65,575,867,5982
31,80,12,4,15,157,0,18,101,8,28,56,101,1329,0,203,738,172,1430
31,81,62,65,326,1192,212,68,212,19,186,515,2789,8787,1751,368,1436,1518,11576
31,83,45,105,29,1039,360,51,40,23,127,743,172,7707,3383,292,282,1068,7879
31,84,10,0,0,0,0,0,0,2,22,0,0,0,0,0,0,0,0
31,86,12,22,942,656,154,50,36,3,69,40,1773,1397,299,90,72,1598,3170
31,95,23,16,97,586,83,66,6,13,59,39,149,1009,176,123,6,683,1158
31,96,125,146,754,17924,645,556,65,11,285,153,1014,18960,810,681,81,18678,19974
31,103,1,0,0,0,0,0,0,1,3,0,0,0,0,0,0,0,0
31,105,24,0,0,0,0,0,0,7,81,0,0,0,0,0,0,0,0
31,106,11,0,0,0,0,0,0,5,31,0,0,0,0,0,0,0,0
31,108,1,0,0,0,0,0,0,1,4,0,0,0,0,0,0,0,0
31,111,5,0,0,0,0,0,0,1,10,0,0,0,0,0,0,0,0
31,112,5,0,0,0,0,0,0,3,17,0,0,0,0,0,0,0,0
31,119,2,0,0,0,0,0,0,1,4,0,0,0,0,0,0,0,0
32,69,5,0,0,0,0,0,0,4,16,0,0,0,0,0,0,0,0
32,70,217,295,916,3880,636,789,529,110,632,2354,5388,26322,5748,5195,3991,4796,31710
32,72,1,0,0,0,0,0,0,1,3,0,0,0,0,0,0,0,0
32,73,179,143,371,3455,647,166,877,97,574,1120,3171,28461,6060,1161,7883,3826,31632
32,74,279,620,1164,6128,1175,236,1446,161,972,5284,9221,52050,11826,1859,12453,7292,61271
32,75,5157,17352,48853,325471,33748,19828,11568,2215,13560,77687,124779,979673,164956,54944,51099,374324,1104452
32,76,271,490,619,6549,1199,250,383,117,745,3056,3374,42944,11330,1187,2458,7168,46318
32,77,1,0,0,0,0,0,0,1,6,0,0,0,0,0,0,0,0
32,78,657,757,2662,12257,2755,176,1523,287,1897,5324,18822,99323,27913,1156,12729,14919,118145
32,79,209,315,788,4183,907,119,410,93,621,2320,5479,31871,9011,680,3068,4971,37350
32,80,172,190,234,4658,353,141,732,37,458,1430,1271,33316,3957,1076,6127,4892,34587
32,81,31,0,0,0,0,0,0,18,105,0,0,0,0,0,0,0,0
32,83,51,33,5,314,96,8,53,16,141,240,30,2189,785,74,350,319,2219
32,87,2,0,0,0,0,0,0,1,6,0,0,0,0,0,0,0,0
32,88,7,0,0,0,0,0,0,3,15,0,0,0,0,0,0,0,0
32,92,1,0,0,0,0,0,0,1,3,0,0,0,0,0,0,0,0
32,94,1,0,0,0,0,0,0,1,4,0,0,0,0,0,0,0,0
32,95,22,21,83,856,72,123,28,15,67,24,129,1368,135,218,32,939,1497
32,96,59,107,492,16159,221,506,55,6,113,151,678,17021,347,761,55,16651,17699
32,99,3,0,0,0,0,0,0,1,5,0,0,0,0,0,0,0,0
32,104,44,0,0,0,0,0,0,5,99,0,0,0,0,0,0,0,0
32,105,3,0,0,0,0,0,0,3,10,0,0,0,0,0,0,0,0
32,106,1,0,0,0,0,0,0,1,3,0,0,0,0,0,0,0,0
32,107,4,0,0,0,0,0,0,3,13,0,0,0,0,0,0,0,0
32,111,2,0,0,0,0,0,0,1,4,0,0,0,0,0,0,0,0
32,112,4,0,0,0,0,0,0,2,11,0,0,0,0,0,0,0,0
32,115,2,0,0,0,0,0,0,1,6,0,0,0,0,0,0,0,0
32,116,2,0,0,0,0,0,0,1,4,0,0,0,0,0,0,0,0
32,117,3,0,0,0,0,0,0,1,6,0,0,0,0,0,0,0,0
33,72,374,492,1098,6334,728,268,3045,88,968,4370,8805,53270,7902,2477,24132,7432,62075
33,74,99,89,527,4273,498,310,84,60,255,285,1610,14501,2224,926,301,4800,16111
33,75,409,484,1209,18067,2035,1313,243,294,1155,2082,4098,63607,10927,4491,808,19276,67705
33,76,10,0,6,204,23,53,2,5,28,0,16,1045,222,212,6,210,1061
33,77,2,0,0,0,0,0,0,1,8,0,0,0,0,0,0,0,0
33,78,22,17,32,431,94,30,18,17,65,174,129,2958,893,118,108,463,3087
33,79,2,0,0,0,0,0,0,1,8,0,0,0,0,0,0,0,0
33,80,42,22,42,897,352,42,126,18,142,126,151,7698,3691,292,1148,939,7849
33,82,80,61,36,1257,354,79,65,31,208,273,311,8554,3162,410,426,1293,8865
33,85,15,0,0,0,0,0,0,5,31,0,0,0,0,0,0,0,0
33,86,2,0,0,0,0,0,0,2,6,0,0,0,0,0,0,0,0
33,87,7,0,0,0,0,0,0,3,14,0,0,0,0,0,0,0,0
33,89,2,0,0,0,0,0,0,1,4,0,0,0,0,0,0,0,0
33,90,1,0,0,0,0,0,0,1,3,0,0,0,0,0,0,0,0
33,94,53,123,139,1757,334,247,12,14,120,683,281,4467,744,679,48,1896,4748
33,95,16,0,0,0,0,0,0,5,40,0,0,0,0,0,0,0,0
33,106,4,0,0,0,0,0,0,2,8,0,0,0,0,0,0,0,0
33,109,6,0,0,0,0,0,0,4,17,0,0,0,0,0,0,0,0
33,110,24,0,0,0,0,0,0,1,52,0,0,0,0,0,0,0,0
33,112,6,0,0,0,0,0,0,2,11,0,0,0,0,0,0,0,0
33,113,2,0,0,0,0,0,0,2,5,0,0,0,0,0,0,0,0
33,115,54,0,0,0,0,0,0,2,153,0,0,0,0,0,0,0,0
33,117,4,0,0,0,0,0,0,2,10,0,0,0,0,0,0,0,0
33,120,3,0,0,0,0,0,0,1,8,0,0,0,0,0,0,0,0
34,67,77,57,83,801,104,167,291,37,197,517,930,7310,834,1408,3165,884,8240
34,71,28,0,0,0,0,0,0,6,84,0,0,0,0,0,0,0,0
34,72,303,183,781,4426,685,80,1804,154,886,1721,6218,39694,7580,664,15845,5207,45912
34,73,2296,3130,7066,46795,7916,1253,6764,809,6394,19214,40889,333478,72391,7027,50810,53861,374367
34,74,160,107,469,3837,569,65,561,87,521,707,2922,28970,5677,392,4599,4306,31892
34,75,13,0,0,0,0,0,0,4,40,0,0,0,0,0,0,0,0
34,76,33,28,38,432,146,29,0,19,99,280,231,3422,1432,187,0,470,3653
34,77,12,0,0,0,0,0,0,7,35,0,0,0,0,0,0,0,0
34,78,10,4,18,74,28,3,3,9,35,16,124,605,294,14,30,92,729
34,79,214,232,476,3293,1150,57,641,90,657,1952,3350,29371,12040,572,5402,3769,32721
34,80,314,827,650,6622,2256,109,1107,88,813,5696,4290,49838,19295,582,8119,7272,54128
34,81,68,72,25,1107,219,55,78,17,170,450,89,6585,1428,359,475,1132,6674
34,86,44,0,0,0,0,0,0,2,90,0,0,0,0,0,0,0,0
34,88,4,0,0,0,0,0,0,2,8,0,0,0,0,0,0,0,0
34,89,6,0,0,0,0,0,0,3,12,0,0,0,0,0,0,0,0
34,92,5,0,0,0,0,0,0,2,10,0,0,0,0,0,0,0,0
34,93,5,0,0,0,0,0,0,1,10,0,0,0,0,0,0,0,0
34,94,6,3,21,184,25,8,0,4,12,3,35,446,67,14,0,205,481
34,101,8,0,0,0,0,0,0,2,16,0,0,0,0,0,0,0,0
34,102,3,0,0,0,0,0,0,3,11,0,0,0,0,0,0,0,0
34,107,3,0,0,0,0,0,0,1,18,0,0,0,0,0,0,0,0
34,110,27,0,0,0,0,0,0,8,59,0,0,0,0,0,0,0,0
34,111,8,0,0,0,0,0,0,3,18,0,0,0,0,0,0,0,0
34,112,19,0,0,0,0,0,0,1,55,0,0,0,0,0,0,0,0
34,113,20,0,0,0,0,0,0,1,40,0,0,0,0,0,0,0,0
34,114,1,0,0,0,0,0,0,1,6,0,0,0,0,0,0,0,0
34,117,9,0,0,0,0,0,0,3,18,0,0,0,0,0,0,0,0
34,119,6,0,0,0,0,0,0,2,28,0,0,0,0,0,0,0,0
34,120,2,0,0,0,0,0,0,1,8,0,0,0,0,0,0,0,0
35,66,1,0,0,0,0,0,0,1,2,0,0,0,0,0,0,0,0
35,70,4,15,0,54,2,10,9,4,16,182,0,542,14,119,81,54,542
35,71,228,219,281,4025,444,75,2183,106,707,1991,2141,36768,4781,761,20108,4306,38909
35,73,358,343,604,5077,1257,154,716,104,953,2327,4149,41364,12566,986,6120,5681,45513
35,75,16,0,0,0,0,0,0,9,43,0,0,0,0,0,0,0,0
35,76,5,0,0,0,0,0,0,4,24,0,0,0,0,0,0,0,0
35,77,18,0,0,0,0,0,0,8,51,0,0,0,0,0,0,0,0
35,78,2,0,0,0,0,0,0,1,6,0,0,0,0,0,0,0,0
35,79,266,182,493,4984,1217,261,677,138,789,1419,3593,42062,12768,2185,5338,5477,45655
35,81,351,358,377,8523,2031,421,2534,38,1021,2102,2759,52193,10488,1673,20834,8900,54952
35,87,146,43,1658,3103,225,1493,125,14,301,104,4282,4695,338,1758,433,4761,8977
35,88,8,0,0,0,0,0,0,2,17,0,0,0,0,0,0,0,0
35,90,27,39,425,737,92,147,24,6,64,57,1171,1624,139,331,31,1162,2795
35,95,11,2,2,395,28,44,3,5,25,4,2,650,44,59,30,397,652
35,99,2,0,0,0,0,0,0,1,4,0,0,0,0,0,0,0,0
35,102,10,3,25,256,50,36,0,6,30,11,65,832,296,67,0,281,897
35,105,2500,0,0,0,0,0,0,1,5000,0,0,0,0,0,0,0,0
35,108,2,0,0,0,0,0,0,1,4,0,0,0,0,0,0,0,0
35,111,123,0,0,0,0,0,0,17,356,0,0,0,0,0,0,0,0
35,112,75,0,0,0,0,0,0,7,158,0,0,0,0,0,0,0,0
35,115,5,0,0,0,0,0,0,2,14,0,0,0,0,0,0,0,0
35,116,13,0,0,0,0,0,0,2,26,0,0,0,0,0,0,0,0
35,117,6,0,0,0,0,0,0,3,13,0,0,0,0,0,0,0,0
36,65,3,0,0,0,0,0,0,1,6,0,0,0,0,0,0,0,0
36,70,544,444,1072,7485,595,296,4576,175,1584,3673,10519,67829,6292,2256,41381,8557,78348
36,71,511,492,979,7211,659,129,2312,168,1423,4182,7964,59770,7451,1645,19545,8190,67734
36,72,525,354,860,7416,954,174,1901,156,1396,3046,5423,61563,9697,986,17113,8276,66986
36,73,22,0,0,0,0,0,0,6,46,0,0,0,0,0,0,0,0
36,74,29,55,11,540,162,21,4,12,83,310,77,3752,1572,145,16,551,3829
36,76,16,61,15,544,166,22,1,8,46,426,43,4075,1645,96,1,559,4118
36,77,9,0,0,0,0,0,0,4,33,0,0,0,0,0,0,0,0
36,78,26,22,25,495,161,26,6,13,69,83,63,3144,1573,108,52,520,3207
36,80,1602,3413,3471,50536,10944,1476,4121,300,4234,16615,14262,282139,61245,5561,20565,54007,296401
36,81,10,0,0,0,0,0,0,4,32,0,0,0,0,0,0,0,0
36,95,18,0,0,0,0,0,0,5,37,0,0,0,0,0,0,0,0
36,96,1,0,0,0,0,0,0,1,2,0,0,0,0,0,0,0,0
36,99,25,15,73,1967,171,203,19,15,80,27,162,3446,343,344,21,2040,3608
36,110,1,0,0,0,0,0,0,1,2,0,0,0,0,0,0,0,0
36,111,1,0,0,0,0,0,0,1,4,0,0,0,0,0,0,0,0
36,112,1,0,0,0,0,0,0,1,2,0,0,0,0,0,0,0,0
36,113,288,468,2120,10968,1206,356,201,35,745,567,4211,14553,1831,498,356,13088,18764
36,114,39,0,0,0,0,0,0,2,72,0,0,0,0,0,0,0,0
36,115,8,0,0,0,0,0,0,4,21,0,0,0,0,0,0,0,0
36,121,1,0,0,0,0,0,0,1,2,0,0,0,0,0,0,0,0
36,123,17,0,0,0,0,0,0,1,34,0,0,0,0,0,0,0,0
37,68,1,0,0,0,0,0,0,1,4,0,0,0,0,0,0,0,0
37,69,129,56,161,970,74,5,451,27,386,588,1221,8458,872,26,3960,1131,9679
37,70,4501,8717,27359,132769,15048,4154,24246,847,12121,46082,130398,780072,106974,18430,171485,160128,910470
37,71,1319,821,10229,30947,2768,236,8038,253,3462,6530,64056,230743,27457,1645,60189,41176,294799
37,72,11,0,0,0,0,0,0,5,32,0,0,0,0,0,0,0,0
37,73,7,0,0,0,0,0,0,2,18,0,0,0,0,0,0,0,0
37,74,11,0,0,0,0,0,0,3,26,0,0,0,0,0,0,0,0
37,77,13,0,0,68,32,5,4,9,45,0,0,663,401,55,20,68,663
37,78,271,376,1050,8416,2504,280,706,100,729,1993,5925,41426,18478,913,4930,9466,47351
37,79,390,602,466,9671,2949,411,678,101,1052,3194,2581,53730,17513,1564,3654,10137,56311
37,80,372,700,627,7358,1367,149,494,111,982,4831,3509,50172,12537,704,3199,7985,53681
37,95,7,0,0,0,0,0,0,2,14,0,0,0,0,0,0,0,0
37,103,27,32,132,1975,91,85,5,11,64,50,217,3163,149,270,5,2107,3380
37,104,63,0,0,0,0,0,0,3,127,0,0,0,0,0,0,0,0
37,105,1,0,0,0,0,0,0,1,3,0,0,0,0,0,0,0,0
37,106,4,0,0,0,0,0,0,1,8,0,0,0,0,0,0,0,0
37,107,2,0,0,0,0,0,0,2,7,0,0,0,0,0,0,0,0
37,110,2,0,0,0,0,0,0,1,3,0,0,0,0,0,0,0,0
37,111,1,0,0,0,0,0,0,1,5,0,0,0,0,0,0,0,0
37,112,23,0,0,0,0,0,0,6,51,0,0,0,0,0,0,0,0
37,113,4,0,0,0,0,0,0,1,8,0,0,0,0,0,0,0,0
37,115,17,0,0,0,0,0,0,4,35,0,0,0,0,0,0,0,0
37,119,15,0,0,0,0,0,0,1,34,0,0,0,0,0,0,0,0
37,120,7,0,0,0,0,0,0,2,36,0,0,0,0,0,0,0,0
37,122,4,0,0,0,0,0,0,1,8,0,0,0,0,0,0,0,0
38,68,6,11,24,103,12,10,29,4,18,35,142,801,135,54,195,127,943
38,69,2422,3733,5753,50893,9779,2122,13102,342,6877,28080,42616,389035,85603,15605,97494,56646,431651
38,70,274,44,510,1231,159,24,163,40,833,246,3598,8705,1579,188,1084,1741,12303
38,71,9,0,0,0,0,0,0,2,22,0,0,0,0,0,0,0,0
38,72,60,55,178,688,218,11,17,22,152,372,1273,6215,2411,79,202,866,7488
38,73,9,0,0,0,0,0,0,4,26,0,0,0,0,0,0,0,0
38,74,17,0,0,0,0,0,0,4,35,0,0,0,0,0,0,0,0
38,75,22,0,0,0,0,0,0,6,49,0,0,0,0,0,0,0,0
38,76,2,0,0,0,0,0,0,1,4,0,0,0,0,0,0,0,0
38,77,2,0,0,0,0,0,0,1,5,0,0,0,0,0,0,0,0
38,78,37,49,35,556,163,4,173,15,85,310,215,4664,1546,34,1362,591,4879
38,79,6,7,0,97,47,0,12,4,16,69,0,954,579,0,94,97,954
38,80,2,0,0,0,0,0,0,2,6,0,0,0,0,0,0,0,0
38,81,1,0,0,0,0,0,0,1,6,0,0,0,0,0,0,0,0
38,95,3,0,0,0,0,0,0,2,6,0,0,0,0,0,0,0,0
38,97,120,312,435,13407,908,721,75,37,263,542,679,21072,1829,1171,112,13842,21751
38,98,30,61,42,3185,326,391,12,12,77,114,60,5515,667,742,18,3227,5575
38,100,10,29,65,598,63,56,0,4,22,73,111,1270,205,93,0,663,1381
38,101,2,0,0,0,0,0,0,2,5,0,0,0,0,0,0,0,0
38,102,1,0,0,0,0,0,0,1,2,0,0,0,0,0,0,0,0
38,103,175,273,1409,15699,664,786,96,83,475,471,2134,22665,1174,1218,128,17108,24799
38,104,1,0,0,0,0,0,0,1,4,0,0,0,0,0,0,0,0
38,110,7,0,0,0,0,0,0,1,25,0,0,0,0,0,0,0,0
38,111,20,0,95,248,8,41,0,6,50,0,171,295,8,52,0,343,466
38,118,105,0,0,0,0,0,0,3,210,0,0,0,0,0,0,0,0
38,119,6,0,0,0,0,0,0,1,12,0,0,0,0,0,0,0,0
38,120,10,0,0,0,0,0,0,1,20,0,0,0,0,0,0,0,0
38,121,6,0,0,0,0,0,0,2,42,0,0,0,0,0,0,0,0
38,122,5,0,0,0,0,0,0,2,10,0,0,0,0,0,0,0,0
38,123,1,0,0,0,0,0,0,1,2,0,0,0,0,0,0,0,0
38,125,2,0,0,0,0,0,0,1,4,0,0,0,0,0,0,0,0
39,69,1052,1764,1824,18071,4010,454,1930,262,2801,13844,13221,141727,36321,3165,14510,19895,154948
39,71,24,33,101,389,122,60,21,5,52,147,227,2118,1142,222,68,490,2345
39,72,6,0,0,0,0,0,0,1,12,0,0,0,0,0,0,0,0
39,74,2,0,0,0,0,0,0,1,3,0,0,0,0,0,0,0,0
39,75,4,0,0,0,0,0,0,1,9,0,0,0,0,0,0,0,0
39,76,5,0,0,0,0,0,0,2,12,0,0,0,0,0,0,0,0
39,77,220,375,503,5334,1575,167,493,63,630,1763,2225,27342,10413,566,2325,5837,29567
39,78,335,376,539,7166,2612,106,498,155,1005,2834,3429,59354,27613,650,3636,7705,62783
39,79,194,0,0,0,0,0,0,73,567,0,0,0,0,0,0,0,0
39,83,2,0,0,0,0,0,0,1,4,0,0,0,0,0,0,0,0
39,84,2,0,0,0,0,0,0,1,4,0,0,0,0,0,0,0,0
39,86,32,0,0,0,0,0,0,1,64,0,0,0,0,0,0,0,0
39,90,3,0,0,0,0,0,0,1,6,0,0,0,0,0,0,0,0
39,96,728,4141,5368,139505,8356,7926,1008,101,1619,6731,7790,180643,14311,11431,1137,144873,188433
39,97,127,357,156,13894,1117,881,59,34,279,618,226,20509,2068,1318,75,14050,20735
39,98,924,618,836,26319,1882,2115,145,109,2570,1131,1608,42893,4032,3589,180,27155,44501
39,99,518,2438,1630,61913,11190,5449,349,85,1292,4249,2177,105866,21453,9511,535,63543,108043
39,100,135,378,609,14550,1304,1238,79,42,343,693,1173,23860,2663,2123,116,15159,25033
39,101,8,0,0,0,0,0,0,5,23,0,0,0,0,0,0,0,0
39,102,1,0,0,0,0,0,0,1,2,0,0,0,0,0,0,0,0
39,103,3,0,0,0,0,0,0,2,9,0,0,0,0,0,0,0,0
39,109,16,0,0,0,0,0,0,2,40,0,0,0,0,0,0,0,0
39,119,2,0,0,0,0,0,0,1,4,0,0,0,0,0,0,0,0
39,120,1,0,0,0,0,0,0,1,3,0,0,0,0,0,0,0,0
39,121,18,0,0,0,0,0,0,7,35,0,0,0,0,0,0,0,0
39,122,94,0,0,0,0,0,0,18,209,0,0,0,0,0,0,0,0
39,124,7,0,0,0,0,0,0,2,15,0,0,0,0,0,0,0,0
40,67,1734,3022,7933,32012,4981,2245,7407,559,4855,22357,50990,248383,46999,16093,60377,39945,299373
40,70,1,0,0,0,0,0,0,1,4,0,0,0,0,0,0,0,0
40,72,4,0,0,0,0,0,0,1,8,0,0,0,0,0,0,0,0
40,73,10,0,0,0,0,0,0,3,19,0,0,0,0,0,0,0,0
40,75,5,0,2,76,6,6,0,4,12,0,10,369,66,24,0,78,379
40,76,505,504,1396,8543,2594,94,1654,263,1627,3466,9096,68268,25425,659,13028,9939,77364
40,77,3,0,0,0,0,0,0,3,11,0,0,0,0,0,0,0,0
40,88,2,0,0,0,0,0,0,1,4,0,0,0,0,0,0,0,0
40,90,2,0,0,0,0,0,0,1,5,0,0,0,0,0,0,0,0
40,93,98,138,217,8359,675,1036,35,25,231,240,350,12592,1213,1668,39,8576,12942
40,94,91,185,104,6927,547,904,35,29,214,327,203,12470,1124,1559,50,7031,12673
40,95,47,68,17,1383,193,153,3,14,109,132,20,2312,390,279,3,1400,2332
40,96,31,123,118,5019,508,536,59,12,87,235,154,7674,879,826,78,5137,7828
40,97,2,0,0,0,0,0,0,1,6,0,0,0,0,0,0,0,0
40,98,51,46,16,1777,148,174,1,21,141,72,24,2702,241,287,1,1793,2726
40,99,20,48,85,1991,144,179,32,12,53,60,138,3419,378,318,65,2076,3557
40,100,4,0,0,0,0,0,0,3,17,0,0,0,0,0,0,0,0
40,102,2,0,0,0,0,0,0,1,2,0,0,0,0,0,0,0,0
40,118,3,0,0,0,0,0,0,1,8,0,0,0,0,0,0,0,0
40,119,2,0,0,0,0,0,0,1,4,0,0,0,0,0,0,0,0
40,121,8,0,0,0,0,0,0,2,13,0,0,0,0,0,0,0,0
40,122,43,0,0,0,0,0,0,6,75,0,0,0,0,0,0,0,0
40,124,72,0,0,0,0,0,0,6,132,0,0,0,0,0,0,0,0
41,66,1056,2045,2848,24160,5421,1516,4783,236,3017,17594,18803,198976,57512,11764,36567,27008,217779
41,67,2377,3261,3386,34718,8437,2381,4015,423,6787,28187,23444,263824,86967,15831,31031,38104,287268
41,68,49,42,20,762,248,44,45,5,153,260,148,4745,1888,218,190,782,4893
41,70,4,0,0,0,0,0,0,1,8,0,0,0,0,0,0,0,0
41,71,1,0,0,0,0,0,0,1,2,0,0,0,0,0,0,0,0
41,72,3,0,0,0,0,0,0,1,6,0,0,0,0,0,0,0,0
41,76,121,121,499,2668,417,45,352,85,415,863,3395,20387,4053,288,2626,3167,23782
41,77,7,0,0,0,0,0,0,3,20,0,0,0,0,0,0,0,0
41,78,6,0,0,0,0,0,0,3,13,0,0,0,0,0,0,0,0
41,82,12,0,0,0,0,0,0,2,53,0,0,0,0,0,0,0,0
41,83,12,0,0,0,0,0,0,6,32,0,0,0,0,0,0,0,0
41,92,3,0,0,0,0,0,0,2,9,0,0,0,0,0,0,0,0
41,93,491,142,241,5165,310,359,124,86,1255,246,349,7043,496,573,142,5406,7392
41,96,18,0,0,0,0,0,0,5,76,0,0,0,0,0,0,0,0
41,97,50,0,0,0,0,0,0,8,152,0,0,0,0,0,0,0,0
41,117,31,0,0,0,0,0,0,15,90,0,0,0,0,0,0,0,0
41,121,1,0,0,0,0,0,0,1,3,0,0,0,0,0,0,0,0
41,122,55,0,0,0,0,0,0,1,160,0,0,0,0,0,0,0,0
41,123,1,0,0,0,0,0,0,1,4,0,0,0,0,0,0,0,0
41,124,27,0,0,0,0,0,0,2,59,0,0,0,0,0,0,0,0
41,127,1,0,0,0,0,0,0,1,2,0,0,0,0,0,0,0,0
42,63,47,53,191,563,63,32,273,27,125,477,1474,5151,799,191,2578,754,6625
42,66,233,422,313,3311,801,243,477,63,585,3792,2510,29507,9512,2698,3864,3624,32017
42,67,1536,1576,6431,23841,3147,461,6509,439,4286,11211,47011,169451,30737,2674,48058,30272,216462
42,68,1,0,0,0,0,0,0,1,2,0,0,0,0,0,0,0,0
42,69,12,0,0,0,0,0,0,6,30,0,0,0,0,0,0,0,0
42,70,13,0,0,0,0,0,0,5,30,0,0,0,0,0,0,0,0
42,72,13,0,0,0,0,0,0,4,26,0,0,0,0,0,0,0,0
42,73,9,0,0,0,0,0,0,3,19,0,0,0,0,0,0,0,0
42,74,1,0,0,0,0,0,0,1,4,0,0,0,0,0,0,0,0
42,77,5,0,0,0,0,0,0,1,10,0,0,0,0,0,0,0,0
42,82,8,0,0,0,0,0,0,2,24,0,0,0,0,0,0,0,0
42,87,5,0,0,0,0,0,0,2,10,0,0,0,0,0,0,0,0
42,92,8,0,0,0,0,0,0,1,17,0,0,0,0,0,0,0,0
42,99,1,0,0,0,0,0,0,1,2,0,0,0,0,0,0,0,0
42,116,10,0,0,0,0,0,0,3,22,0,0,0,0,0,0,0,0
42,119,5,0,0,0,0,0,0,3,16,0,0,0,0,0,0,0,0
42,121,118,0,0,0,0,0,0,4,308,0,0,0,0,0,0,0,0
42,122,293,0,0,0,0,0,0,16,575,0,0,0,0,0,0,0,0
42,123,51,90,632,2020,112,556,61,12,110,195,898,2927,233,651,76,2652,3825
42,127,5,0,0,0,0,0,0,2,12,0,0,0,0,0,0,0,0
43,64,76,126,195,955,114,106,233,38,212,1000,1410,7584,1048,841,1804,1150,8994
43,66,52,23,89,863,133,15,47,25,142,165,731,6985,1362,100,351,952,7716
43,67,4,0,0,0,0,0,0,1,7,0,0,0,0,0,0,0,0
43,68,2,0,0,0,0,0,0,2,8,0,0,0,0,0,0,0,0
43,69,4,0,0,0,0,0,0,1,7,0,0,0,0,0,0,0,0
43,70,3,0,0,0,0,0,0,1,6,0,0,0,0,0,0,0,0
43,71,3,0,0,0,0,0,0,1,7,0,0,0,0,0,0,0,0
43,78,21,0,0,0,0,0,0,3,64,0,0,0,0,0,0,0,0
43,81,4,0,0,0,0,0,0,2,8,0,0,0,0,0,0,0,0
43,91,2,0,0,0,0,0,0,1,4,0,0,0,0,0,0,0,0
43,108,3,0,0,0,0,0,0,1,6,0,0,0,0,0,0,0,0
43,120,3,0,0,0,0,0,0,1,6,0,0,0,0,0,0,0,0
43,121,11,12,132,157,2,5,26,5,28,28,202,289,2,26,33,289,491
43,122,534,73,707,2134,174,79,124,43,1145,163,2142,5498,456,190,211,2841,7640
43,123,92,75,1438,2555,153,180,88,52,245,186,4335,7101,446,482,164,3993,11436
43,124,2,0,0,0,0,0,0,2,7,0,0,0,0,0,0,0,0
43,125,59,0,0,0,0,0,0,2,111,0,0,0,0,0,0,0,0
43,127,305,0,0,0,0,0,0,10,533,0,0,0,0,0,0,0,0
44,65,1321,2123,3749,26634,3642,607,2437,517,3638,14248,24781,204340,34127,4513,17780,30383,229121
44,66,5105,10731,35174,144053,17064,3593,12827,1332,12782,55598,134299,790725,123408,15944,70525,179227,925024
44,67,1,0,0,0,0,0,0,1,2,0,0,0,0,0,0,0,0
44,68,5,0,0,0,0,0,0,2,14,0,0,0,0,0,0,0,0
44,69,6,0,0,0,0,0,0,4,18,0,0,0,0,0,0,0,0
44,70,1,0,0,0,0,0,0,1,4,0,0,0,0,0,0,0,0
44,78,1,0,0,0,0,0,0,1,4,0,0,0,0,0,0,0,0
44,83,4,0,0,0,0,0,0,1,13,0,0,0,0,0,0,0,0
44,86,3,0,0,0,0,0,0,1,6,0,0,0,0,0,0,0,0
44,112,2,0,0,0,0,0,0,1,4,0,0,0,0,0,0,0,0
44,118,2,0,0,0,0,0,0,1,3,0,0,0,0,0,0,0,0
44,120,12,0,0,0,0,0,0,2,22,0,0,0,0,0,0,0,0
44,121,150,0,0,0,0,0,0,1,295,0,0,0,0,0,0,0,0
44,122,207,769,6908,16025,1052,700,922,74,423,1315,11828,31126,1938,1312,1547,22933,42954
44,123,9364,26566,141955,838789,49325,48555,20147,1684,19398,43821,253209,1511267,94283,95227,32471,980744,1764476
44,124,48,9,95,305,24,17,4,10,102,20,150,612,65,27,4,400,762
44,127,14,0,0,0,0,0,0,2,26,0,0,0,0,0,0,0,0
45,64,10,0,36,61,6,5,11,7,27,0,284,508,69,67,97,97,792
45,65,1299,1267,3193,27951,2816,288,3444,432,3594,9062,22468,207106,26882,2369,25423,31144,229574
45,66,133,154,528,3106,457,108,265,58,358,879,2664,18388,4042,495,1601,3634,21052
45,67,2,0,0,0,0,0,0,2,4,0,0,0,0,0,0,0,0
45,69,4,0,0,0,0,0,0,1,12,0,0,0,0,0,0,0,0
45,70,1,0,0,0,0,0,0,1,4,0,0,0,0,0,0,0,0
45,81,25,7,119,373,41,76,16,11,61,13,484,748,80,266,20,492,1232
45,82,1,0,0,0,0,0,0,1,4,0,0,0,0,0,0,0,0
45,108,176,98,9627,7729,115,141,928,23,294,249,36577,13121,448,399,2473,17356,49698
45,109,3,0,0,0,0,0,0,1,7,0,0,0,0,0,0,0,0
45,114,3,0,0,0,0,0,0,3,7,0,0,0,0,0,0,0,0
45,121,62,0,0,0,0,0,0,6,118,0,0,0,0,0,0,0,0
45,122,7,0,0,0,0,0,0,3,33,0,0,0,0,0,0,0,0
45,123,33,6,134,189,14,8,11,14,77,29,428,878,30,38,25,323,1306
45,124,40,0,0,0,0,0,0,7,250,0,0,0,0,0,0,0,0
45,127,1,0,0,0,0,0,0,1,2,0,0,0,0,0,0,0,0
46,64,288,140,886,8337,813,270,175,50,798,927,5462,34388,3774,1357,1133,9223,39850
46,65,116,152,401,4497,609,333,192,86,309,869,1656,18892,4476,1033,1086,4898,20548
46,66,94,68,141,1655,205,85,78,36,210,305,473,6903,1071,299,395,1796,7376
46,67,138,137,250,2175,881,61,165,72,379,1395,1681,18253,9550,304,1361,2425,19934
46,68,10,0,0,0,0,0,0,6,30,0,0,0,0,0,0,0,0
46,71,2,0,0,0,0,0,0,1,4,0,0,0,0,0,0,0,0
46,83,2,0,0,0,0,0,0,1,6,0,0,0,0,0,0,0,0
46,88,14,0,0,0,0,0,0,5,36,0,0,0,0,0,0,0,0
46,116,4,0,0,0,0,0,0,1,8,0,0,0,0,0,0,0,0
46,117,6,0,0,0,0,0,0,2,11,0,0,0,0,0,0,0,0
46,120,72,4,3,20,2,0,0,13,135,4,3,31,2,0,0,23,34
46,121,149,118,2146,9690,419,230,287,27,287,139,2842,13248,574,299,486,11836,16090
46,122,4,0,0,0,0,0,0,1,8,0,0,0,0,0,0,0,0
46,123,176,947,4857,7203,674,680,228,15,361,1717,7807,11757,1423,1298,342,12060,19564
46,124,27,0,0,0,0,0,0,5,47,0,0,0,0,0,0,0,0
47,61,471,40,55,1289,197,34,32,55,1085,297,400,9585,1738,263,222,1344,9985
47,62,495,653,496,11682,1492,365,452,174,1452,4811,2818,90425,13865,2761,3168,12178,93243
47,63,908,890,2626,19768,2757,594,1440,402,2496,6368,13400,147477,26071,4056,10155,22394,160877
47,64,108,85,263,1807,291,92,126,33,266,471,1039,10417,2312,388,528,2070,11456
47,65,3712,13094,34167,179570,28389,7317,6476,621,9119,69776,100436,877251,184683,27890,31518,213737,977687
47,66,70,47,135,1799,278,85,37,38,205,238,840,8263,1946,177,135,1934,9103
47,67,285,942,2074,15096,2158,831,407,91,754,2178,6475,35590,6892,1883,1205,17170,42065
47,68,72,149,142,4087,658,378,88,23,191,241,235,6748,1164,574,144,4229,6983
47,70,4,0,0,0,0,0,0,1,12,0,0,0,0,0,0,0,0
47,110,8,0,0,0,0,0,0,1,16,0,0,0,0,0,0,0,0
47,113,3,0,0,0,0,0,0,1,6,0,0,0,0,0,0,0,0
47,120,13,0,0,0,0,0,0,2,27,0,0,0,0,0,0,0,0
47,123,66,0,0,0,0,0,0,2,116,0,0,0,0,0,0,0,0
47,124,24,0,0,0,0,0,0,4,47,0,0,0,0,0,0,0,0
48,60,759,843,889,17950,1670,292,921,314,2297,6143,6606,144897,15875,1991,7223,18839,151503
48,61,1882,4713,3031,56017,10007,1818,3932,537,5624,31736,19297,386850,72624,9411,32247,59048,406147
48,62,850,692,1545,16486,1827,403,2309,342,2527,6645,12652,141600,20062,3212,21635,18031,154252
48,63,90,107,169,1923,454,72,308,30,291,899,1126,14807,4334,364,2514,2092,15933
48,64,570,304,921,11302,1390,288,733,241,1610,2326,7041,91428,13996,2364,6010,12223,98469
48,65,13,54,30,409,192,13,0,13,64,434,209,3825,2025,65,0,439,4034
48,66,124,436,1048,18318,2297,600,119,31,294,709,1706,28508,5169,958,264,19366,30214
48,67,9,10,13,230,34,19,1,5,22,22,14,440,138,21,1,243,454
48,68,1,0,0,0,0,0,0,1,4,0,0,0,0,0,0,0,0
48,69,1,0,0,0,0,0,0,1,3,0,0,0,0,0,0,0,0
48,70,20,0,0,0,0,0,0,4,39,0,0,0,0,0,0,0,0
48,121,9,1,12,48,1,5,4,4,21,1,22,71,4,5,5,60,93
48,126,1,0,0,0,0,0,0,1,2,0,0,0,0,0,0,0,0
49,59,1007,956,867,22371,3247,319,1347,418,3100,7713,6267,189699,33795,2473,11657,23238,195966
49,60,1268,1636,2697,29472,3277,479,1417,496,3781,10803,18065,229245,29325,3026,11221,32169,247310
49,61,6,0,0,0,0,0,0,3,15,0,0,0,0,0,0,0,0
49,62,2,0,0,0,0,0,0,2,8,0,0,0,0,0,0,0,0
49,64,19,29,73,381,93,42,2,13,59,155,325,2195,704,166,2,454,2520
49,66,10,0,0,0,0,0,0,1,20,0,0,0,0,0,0,0,0
49,67,12,0,0,0,0,0,0,8,41,0,0,0,0,0,0,0,0
49,68,2,0,0,0,0,0,0,2,10,0,0,0,0,0,0,0,0
49,69,28,14,55,312,75,28,0,9,72,36,69,942,319,85,0,367,1011
49,71,5,0,0,0,0,0,0,4,25,0,0,0,0,0,0,0,0
49,72,6,7,0,114,16,4,9,4,18,20,0,654,78,18,46,114,654
49,86,2,0,0,0,0,0,0,1,4,0,0,0,0,0,0,0,0
49,114,2,0,0,0,0,0,0,1,4,0,0,0,0,0,0,0,0
49,115,1,0,0,0,0,0,0,1,2,0,0,0,0,0,0,0,0
49,117,1,0,0,0,0,0,0,1,5,0,0,0,0,0,0,0,0
49,123,31,0,0,0,0,0,0,2,66,0,0,0,0,0,0,0,0
49,127,2,0,0,0,0,0,0,1,3,0,0,0,0,0,0,0,0
50,45,7,2,11,71,6,8,24,6,24,18,55,722,52,33,437,82,777
50,59,511,514,275,11028,1306,127,728,226,1612,4173,2020,98022,13850,1122,7060,11303,100042
50,60,3,0,0,0,0,0,0,2,10,0,0,0,0,0,0,0,0
50,61,2,0,0,0,0,0,0,1,9,0,0,0,0,0,0,0,0
50,67,4,0,0,0,0,0,0,2,12,0,0,0,0,0,0,0,0
50,69,2,0,0,0,0,0,0,2,9,0,0,0,0,0,0,0,0
50,72,2,0,0,0,0,0,0,2,10,0,0,0,0,0,0,0,0
50,113,14,0,0,0,0,0,0,5,35,0,0,0,0,0,0,0,0
50,123,14,0,0,0,0,0,0,2,35,0,0,0,0,0,0,0,0
51,57,65,130,117,1043,147,27,130,32,169,1200,1003,9296,1317,277,1109,1160,10299
51,58,17,53,12,322,95,4,25,11,65,455,90,2966,932,56,270,334,3056
51,59,191,83,170,3949,404,47,120,87,585,734,1029,33980,4340,322,954,4119,35009
51,60,18,7,4,99,60,0,0,12,49,37,20,885,640,0,0,103,905
51,61,7,0,0,0,0,0,0,2,16,0,0,0,0,0,0,0,0
51,62,1,0,0,0,0,0,0,1,6,0,0,0,0,0,0,0,0
51,63,3,0,0,0,0,0,0,1,6,0,0,0,0,0,0,0,0
51,64,6,0,0,0,0,0,0,3,14,0,0,0,0,0,0,0,0
51,68,1,0,0,0,0,0,0,1,4,0,0,0,0,0,0,0,0
51,70,11,0,0,0,0,0,0,5,26,0,0,0,0,0,0,0,0
51,112,2,0,0,0,0,0,0,1,4,0,0,0,0,0,0,0,0
51,113,24,30,290,234,26,41,46,6,50,45,624,518,52,110,111,524,1142
52,46,642,404,5577,11630,756,445,1764,189,1790,3195,30950,75363,5323,2895,12855,17207,106313
52,57,11,0,0,0,0,0,0,4,26,0,0,0,0,0,0,0,0
52,58,53,91,4,734,205,31,71,32,165,772,42,6750,2264,312,722,738,6792
52,59,768,648,618,16227,2957,282,885,308,2294,5131,4238,136002,30531,2194,7152,16845,140240
52,60,318,119,353,5372,687,76,264,144,928,1029,2627,46538,7530,577,2251,5725,49165
52,61,3,0,0,0,0,0,0,1,6,0,0,0,0,0,0,0,0
52,62,2,0,0,0,0,0,0,2,5,0,0,0,0,0,0,0,0
52,63,2,0,0,0,0,0,0,1,8,0,0,0,0,0,0,0,0
52,65,3,0,0,0,0,0,0,1,6,0,0,0,0,0,0,0,0
52,66,6,0,0,0,0,0,0,2,16,0,0,0,0,0,0,0,0
52,67,2,0,0,0,0,0,0,1,4,0,0,0,0,0,0,0,0
52,68,1,0,0,0,0,0,0,1,4,0,0,0,0,0,0,0,0
52,69,30,16,156,251,26,31,4,11,69,39,402,1060,135,138,6,407,1462
52,74,32,0,0,0,0,0,0,5,69,0,0,0,0,0,0,0,0
52,114,108,0,0,0,0,0,0,12,215,0,0,0,0,0,0,0,0
52,117,3,0,0,0,0,0,0,2,10,0,0,0,0,0,0,0,0
52,120,73,0,0,0,0,0,0,3,159,0,0,0,0,0,0,0,0
52,121,23,0,0,0,0,0,0,1,46,0,0,0,0,0,0,0,0
52,125,74,0,0,0,0,0,0,2,128,0,0,0,0,0,0,0,0
53,46,27,0,0,0,0,0,0,13,67,0,0,0,0,0,0,0,0
53,47,7,0,0,0,0,0,0,5,14,0,0,0,0,0,0,0,0
53,59,1350,2455,682,48194,11812,1424,1482,305,3955,18790,5007,365883,99975,8334,10147,48876,370890
53,60,83,46,75,1759,229,50,35,38,236,288,479,13210,2136,236,253,1834,13689
53,62,8,0,0,0,0,0,0,3,18,0,0,0,0,0,0,0,0
53,63,7,12,0,78,17,0,0,5,27,98,0,679,146,0,0,78,679
53,66,1,0,0,0,0,0,0,1,6,0,0,0,0,0,0,0,0
53,68,1,0,0,0,0,0,0,1,3,0,0,0,0,0,0,0,0
53,74,8,0,0,0,0,0,0,2,14,0,0,0,0,0,0,0,0
53,75,30,0,0,0,0,0,0,1,46,0,0,0,0,0,0,0,0
53,115,3,0,0,0,0,0,0,1,6,0,0,0,0,0,0,0,0
53,121,3,0,0,0,0,0,0,1,5,0,0,0,0,0,0,0,0
54,46,207,149,575,3368,276,370,641,98,597,1253,4512,26832,2183,2989,6858,3943,31344
54,47,614,232,5712,15010,679,717,2050,243,1516,1544,27026,74116,3641,3901,13603,20722,101142
54,56,159,266,399,3291,537,112,325,75,458,2386,3208,25759,4908,1023,3058,3690,28967
54,59,1075,930,735,26449,3443,557,933,431,3164,6794,5114,199184,32765,3175,7567,27184,204298
54,60,3166,3890,20364,165345,17043,5762,4461,844,7978,16679,64959,582133,91534,16880,25360,185709,647092
54,61,5,0,1,94,55,1,0,4,18,0,13,975,687,18,0,95,988
54,62,4,0,0,0,0,0,0,1,8,0,0,0,0,0,0,0,0
54,68,2,0,0,0,0,0,0,1,8,0,0,0,0,0,0,0,0
54,69,2,0,0,0,0,0,0,1,4,0,0,0,0,0,0,0,0
54,115,1,0,0,0,0,0,0,1,2,0,0,0,0,0,0,0,0
54,121,10,0,0,0,0,0,0,1,22,0,0,0,0,0,0,0,0
55,46,34,23,102,396,39,28,70,23,106,162,957,3165,398,190,876,498,4122
55,47,126,91,298,1909,154,123,445,44,377,853,3377,17164,1408,1314,4926,2207,20541
55,56,75,57,197,1262,262,46,114,47,230,376,977,10208,2331,462,997,1459,11185
55,57,11,7,18,75,20,0,10,9,33,53,176,841,273,0,113,93,1017
55,59,2430,2397,2482,59657,10570,1345,2150,939,7410,17321,17463,450063,95128,7433,15688,62139,467526
55,60,1152,1041,2268,41071,4786,812,1633,443,3437,6551,9274,223093,38899,3388,11485,43339,232367
55,61,56,31,22,1050,204,15,7,32,198,247,171,8576,2086,85,47,1072,8747
55,62,9,0,0,0,0,0,0,4,24,0,0,0,0,0,0,0,0
55,73,3,0,0,0,0,0,0,3,15,0,0,0,0,0,0,0,0
55,119,6,0,0,0,0,0,0,1,12,0,0,0,0,0,0,0,0
55,122,1,0,0,0,0,0,0,1,2,0,0,0,0,0,0,0,0
56,55,34,56,73,636,184,21,22,20,116,475,438,5856,1811,196,248,709,6294
56,56,384,239,1619,5053,514,206,1026,138,1285,1909,12582,45054,5625,1966,10524,6672,57636
56,57,5,16,7,79,10,0,13,3,19,161,7,711,112,0,128,86,718
56,59,684,480,276,14461,1274,124,916,266,1980,4051,2101,119924,12521,861,7762,14737,122025
56,60,113,72,65,2737,362,44,165,54,373,482,512,24107,3726,307,1483,2802,24619
56,61,1790,1252,3965,50766,5774,1245,2871,752,5254,7995,16176,308109,48037,4579,20438,54731,324285
56,63,5,0,0,0,0,0,0,2,14,0,0,0,0,0,0,0,0
56,71,1,0,0,0,0,0,0,1,6,0,0,0,0,0,0,0,0
56,107,35,0,0,0,0,0,0,5,70,0,0,0,0,0,0,0,0
56,111,3,0,0,0,0,0,0,1,6,0,0,0,0,0,0,0,0
56,116,5,0,0,0,0,0,0,1,10,0,0,0,0,0,0,0,0
56,118,19,0,0,0,0,0,0,2,37,0,0,0,0,0,0,0,0
56,127,1,0,0,0,0,0,0,1,3,0,0,0,0,0,0,0,0
57,29,2,0,0,0,0,0,0,1,4,0,0,0,0,0,0,0,0
57,55,8,22,15,124,28,0,33,7,34,220,164,1265,318,0,383,139,1429
57,56,234,160,437,3519,451,110,923,99,665,1436,3304,30386,4298,937,8567,3956,33690
57,61,582,918,2410,19816,2306,559,567,346,1879,4146,7035,105499,17546,2472,2920,22226,112534
57,62,2,0,0,0,0,0,0,1,4,0,0,0,0,0,0,0,0
57,64,9,0,0,84,24,0,0,5,24,0,0,776,239,0,0,84,776
57,71,3,0,0,0,0,0,0,1,12,0,0,0,0,0,0,0,0
57,73,6,0,0,0,0,0,0,2,12,0,0,0,0,0,0,0,0
57,116,17,0,0,0,0,0,0,1,36,0,0,0,0,0,0,0,0
57,122,16,0,0,0,0,0,0,5,33,0,0,0,0,0,0,0,0
57,124,2,0,0,0,0,0,0,1,4,0,0,0,0,0,0,0,0
58,50,1,0,0,0,0,0,0,1,2,0,0,0,0,0,0,0,0
58,54,27,53,22,494,47,26,73,13,81,538,171,4165,460,174,699,516,4336
58,55,43,35,65,1006,96,58,59,12,116,314,435,7640,1014,393,471,1071,8075
58,60,7045,5276,43272,531425,25649,17845,4125,3931,17548,14191,85626,1398615,84245,44942,9731,574697,1484241
58,61,151,95,279,4064,575,177,91,104,502,605,1094,27047,5222,981,393,4343,28141
58,62,10,0,0,0,0,0,0,5,27,0,0,0,0,0,0,0,0
58,63,2,0,0,0,0,0,0,1,3,0,0,0,0,0,0,0,0
58,64,1,0,0,0,0,0,0,1,6,0,0,0,0,0,0,0,0
58,66,1,0,0,0,0,0,0,1,4,0,0,0,0,0,0,0,0
58,71,8,0,0,0,0,0,0,3,16,0,0,0,0,0,0,0,0
58,112,2,0,0,0,0,0,0,1,6,0,0,0,0,0,0,0,0
58,113,19,113,65,700,151,64,49,5,53,223,116,1255,314,97,111,765,1371
58,117,7,0,0,0,0,0,0,1,18,0,0,0,0,0,0,0,0
59,50,3356,2645,6713,175919,6794,6549,3958,762,8030,14253,22517,595462,36964,30662,27317,182632,617979
59,51,83,61,39,2070,112,89,11,28,218,415,231,9575,940,537,111,2109,9806
59,54,5,0,12,123,16,0,5,4,20,0,90,1110,197,0,63,135,1200
59,55,564,787,1126,12401,1297,421,1099,191,1542,5183,6390,88391,11879,2509,8278,13527,94781
59,56,695,1017,1154,13037,1048,322,948,268,1934,8032,8137,105748,9974,2534,9560,14191,113885
59,60,1227,1126,7325,55699,3854,2139,665,613,3137,3888,14778,195772,18105,6979,1954,63024,210550
59,61,276,135,3904,16662,846,446,390,95,787,514,8402,43621,5236,1328,876,20566,52023
59,62,5,0,0,0,0,0,0,2,12,0,0,0,0,0,0,0,0
59,63,4,0,0,0,0,0,0,1,8,0,0,0,0,0,0,0,0
59,64,1,0,0,0,0,0,0,1,4,0,0,0,0,0,0,0,0
59,65,1,0,0,0,0,0,0,1,4,0,0,0,0,0,0,0,0
59,66,3,0,0,0,0,0,0,1,10,0,0,0,0,0,0,0,0
59,112,24,0,0,0,0,0,0,6,59,0,0,0,0,0,0,0,0
59,116,7,0,0,0,0,0,0,2,14,0,0,0,0,0,0,0,0
59,125,4,0,0,0,0,0,0,1,8,0,0,0,0,0,0,0,0
59,127,15,0,0,0,0,0,0,1,23,0,0,0,0,0,0,0,0
60,50,249,261,143,4946,441,322,486,55,592,2144,733,26431,3788,2120,4544,5089,27164
60,51,38,38,19,752,73,62,28,17,98,358,112,5118,628,362,263,771,5230
60,55,11,5,16,106,23,2,0,7,32,70,117,953,238,28,0,122,1070
60,56,284,190,441,5993,797,224,402,124,869,1407,3512,46554,7286,1535,3654,6434,50066
60,57,230,262,1328,8477,953,203,1433,10,474,1904,4966,56350,6893,869,8710,9805,61316
60,59,1417,1822,7277,74778,5443,1128,1220,305,3463,8524,16457,330392,30421,4575,4855,82055,346849
60,60,1521,2616,3296,63843,13227,3086,1698,578,4464,13848,10794,328546,73814,10442,8065,67139,339340
60,61,47,81,10,1406,306,7,8,27,158,551,43,10595,2809,22,37,1416,10638
60,62,6,0,0,0,0,0,0,3,14,0,0,0,0,0,0,0,0
60,63,13,0,0,0,0,0,0,5,40,0,0,0,0,0,0,0,0
60,65,5,0,0,0,0,0,0,3,15,0,0,0,0,0,0,0,0
60,67,1,0,0,0,0,0,0,1,6,0,0,0,0,0,0,0,0
60,69,1,0,0,0,0,0,0,1,6,0,0,0,0,0,0,0,0
60,115,61,0,0,0,0,0,0,5,127,0,0,0,0,0,0,0,0
60,119,20,0,0,0,0,0,0,1,40,0,0,0,0,0,0,0,0
60,122,2,0,0,0,0,0,0,1,4,0,0,0,0,0,0,0,0
60,126,6,0,0,0,0,0,0,2,17,0,0,0,0,0,0,0,0
60,127,82,100,1716,1316,196,131,121,8,218,172,3107,3298,492,302,230,3032,6405
61,39,2,0,0,0,0,0,0,1,4,0,0,0,0,0,0,0,0
61,51,2,0,0,0,0,0,0,2,6,0,0,0,0,0,0,0,0
61,53,28,16,23,512,80,26,61,15,79,138,167,4366,878,192,549,535,4533
61,55,40,30,56,686,108,39,0,17,117,181,281,4266,1111,223,0,742,4547
61,56,1412,1908,4031,51266,7050,981,2949,323,3702,11129,17452,380477,61197,5864,20603,55297,397929
61,57,204,185,573,5267,409,288,281,70,550,1298,2878,31436,2815,1747,2136,5840,34314
61,59,750,564,932,18323,1847,368,690,242,1948,3534,3936,122834,14459,1783,4843,19255,126770
61,60,59,90,56,1804,448,42,8,35,206,720,295,13317,4558,168,35,1860,13612
61,62,208,0,0,0,0,0,0,13,445,0,0,0,0,0,0,0,0
61,63,16,0,0,0,0,0,0,5,42,0,0,0,0,0,0,0,0
61,64,22,15,29,359,86,0,8,7,52,171,48,3220,860,0,9,388,3268
61,65,10,0,0,0,0,0,0,3,20,0,0,0,0,0,0,0,0
61,66,3,0,0,0,0,0,0,1,6,0,0,0,0,0,0,0,0
61,67,8,0,0,0,0,0,0,4,24,0,0,0,0,0,0,0,0
61,68,6,0,0,0,0,0,0,1,12,0,0,0,0,0,0,0,0
61,109,5,0,0,0,0,0,0,1,15,0,0,0,0,0,0,0,0
61,110,1,0,0,0,0,0,0,1,2,0,0,0,0,0,0,0,0
61,116,4,0,0,0,0,0,0,1,9,0,0,0,0,0,0,0,0
61,126,18,0,0,0,0,0,0,3,41,0,0,0,0,0,0,0,0
61,127,84,0,81,31,7,6,0,7,282,0,137,53,13,9,0,112,190
62,50,231,373,164,5649,1087,118,628,57,642,2807,1395,44634,8052,713,6017,5813,46029
62,51,1103,445,5646,28464,1380,1413,2612,242,2682,3283,31916,170062,10605,8168,18214,34110,201978
62,52,28,14,20,631,98,39,10,16,89,103,109,4672,872,286,64,651,4781
62,53,41,37,22,611,73,35,78,13,107,253,238,4452,659,227,559,633,4690
62,56,852,764,2511,19162,2870,859,1575,368,2438,6537,16230,145493,28310,6144,13956,21673,161723
62,57,19,24,4,156,34,9,0,5,45,203,29,1447,381,96,0,160,1476
62,58,396,271,262,7040,846,135,194,176,1156,1973,1794,53042,8069,778,1465,7302,54836
62,59,370,212,245,7458,831,143,204,163,1117,1480,1631,54541,7606,979,1507,7703,56172
62,60,15,11,0,259,89,0,0,9,53,77,0,2239,964,0,0,259,2239
62,62,3,0,0,0,0,0,0,3,18,0,0,0,0,0,0,0,0
62,63,11,3,2,99,19,0,0,5,34,15,18,879,187,0,0,101,897
62,65,78,69,3821,6930,843,117,128,12,139,124,7068,7785,961,288,268,10751,14853
62,66,9,0,0,0,0,0,0,2,18,0,0,0,0,0,0,0,0
62,67,3,0,0,0,0,0,0,1,6,0,0,0,0,0,0,0,0
62,68,5,0,0,0,0,0,0,2,14,0,0,0,0,0,0,0,0
62,110,10,0,0,0,0,0,0,3,26,0,0,0,0,0,0,0,0
62,127,12,0,0,0,0,0,0,2,23,0,0,0,0,0,0,0,0
63,50,309,123,230,6438,279,108,1012,91,954,1159,1982,59705,3196,877,10468,6668,61687
63,51,80,52,122,1331,147,96,112,33,224,474,1177,10409,1435,626,1183,1453,11586
63,52,138,92,84,1921,277,73,299,52,393,835,810,18234,3209,641,3384,2005,19044
63,53,2889,10452,6739,94900,11372,5651,4027,572,7129,75136,30117,589316,86204,30907,30087,101639,619433
63,58,3210,4002,4800,88061,14257,1428,3310,840,8849,22756,18720,542372,104539,5856,17959,92861,561092
63,59,100,15,67,1883,314,23,80,37,312,40,327,13275,2877,83,476,1950,13602
63,62,11,0,0,0,0,0,0,3,25,0,0,0,0,0,0,0,0
63,63,3,0,0,0,0,0,0,2,8,0,0,0,0,0,0,0,0
63,64,17,17,12,162,81,0,0,7,39,98,48,1472,887,0,0,174,1520
63,109,12,0,0,0,0,0,0,1,27,0,0,0,0,0,0,0,0
63,113,2,0,0,0,0,0,0,1,3,0,0,0,0,0,0,0,0
63,118,45,0,0,0,0,0,0,2,58,0,0,0,0,0,0,0,0
64,44,10,12,23,217,18,12,76,7,32,164,241,2101,219,112,874,240,2342
64,45,530,732,919,9139,1752,492,858,263,1355,7131,6091,75376,19091,3297,8836,10058,81467
64,46,14,11,6,221,91,4,6,7,35,140,42,2219,1105,32,98,227,2261
64,49,7,0,0,0,0,0,0,2,18,0,0,0,0,0,0,0,0
64,50,341,456,228,5793,1028,267,1207,103,956,4066,1892,50402,9761,1971,12361,6021,52294
64,51,2109,2303,5641,50712,6006,2567,7513,370,5370,19083,37074,353312,53885,16639,60416,56353,390386
64,54,8,18,12,326,56,22,0,3,17,104,44,1779,483,119,0,338,1823
64,55,15,41,17,255,61,26,0,6,40,403,77,2187,638,236,0,272,2264
64,56,169,71,474,2603,331,155,277,92,476,566,3768,19258,3499,1026,2407,3077,23026
64,58,1365,756,730,30945,2826,193,1514,404,3816,5339,3558,206214,24400,1226,9780,31675,209772
64,59,46,79,5,1189,459,13,1,33,168,707,11,11616,5194,118,1,1194,11627
64,60,1,0,0,0,0,0,0,1,4,0,0,0,0,0,0,0,0
64,61,4,0,0,0,0,0,0,4,18,0,0,0,0,0,0,0,0
64,62,8,0,0,0,0,0,0,3,24,0,0,0,0,0,0,0,0
64,63,72,0,0,0,0,0,0,10,151,0,0,0,0,0,0,0,0
64,64,22,0,0,0,0,0,0,5,52,0,0,0,0,0,0,0,0
64,65,1,0,0,0,0,0,0,1,6,0,0,0,0,0,0,0,0
64,111,7,0,0,0,0,0,0,2,18,0,0,0,0,0,0,0,0
65,44,16,0,0,0,0,0,0,4,34,0,0,0,0,0,0,0,0
65,45,438,272,2528,14662,933,510,1392,9,946,1174,7076,66171,4185,1972,8261,17190,73247
65,46,6,0,0,0,0,0,0,4,11,0,0,0,0,0,0,0,0
65,50,10,17,16,704,81,28,13,6,30,92,69,2388,301,74,92,720,2457
65,55,1,0,0,0,0,0,0,1,2,0,0,0,0,0,0,0,0
65,56,14,10,17,245,47,26,22,9,38,42,142,1632,339,81,164,262,1774
65,58,877,555,781,20022,3286,227,1405,186,2237,3983,4171,139869,25954,1339,8814,20803,144040
65,59,14,0,0,0,0,0,0,7,42,0,0,0,0,0,0,0,0
65,60,2,0,0,0,0,0,0,1,8,0,0,0,0,0,0,0,0
65,62,1,0,0,0,0,0,0,1,6,0,0,0,0,0,0,0,0
65,64,2,0,0,0,0,0,0,1,6,0,0,0,0,0,0,0,0
65,124,8,0,0,0,0,0,0,2,52,0,0,0,0,0,0,0,0
65,125,8,0,0,0,0,0,0,1,15,0,0,0,0,0,0,0,0
65,127,2,0,0,0,0,0,0,2,4,0,0,0,0,0,0,0,0
66,44,12,0,0,0,0,0,0,4,42,0,0,0,0,0,0,0,0
66,45,3,0,0,0,0,0,0,1,10,0,0,0,0,0,0,0,0
66,50,1,0,0,0,0,0,0,1,4,0,0,0,0,0,0,0,0
66,51,3,0,0,0,0,0,0,1,10,0,0,0,0,0,0,0,0
66,56,47,21,48,977,84,27,97,17,135,187,433,8829,799,251,947,1025,9262
66,57,43,20,2,794,68,2,18,13,136,205,14,7022,704,12,170,796,7036
66,58,845,647,526,16857,2672,169,474,253,2299,4656,3710,132750,25074,1247,3672,17383,136460
66,59,13,2,5,206,70,0,0,6,38,20,10,1843,810,0,0,211,1853
66,60,7,0,0,0,0,0,0,4,26,0,0,0,0,0,0,0,0
66,64,4,0,0,0,0,0,0,1,9,0,0,0,0,0,0,0,0
66,121,3,0,0,0,0,0,0,1,7,0,0,0,0,0,0,0,0
67,44,44,30,47,778,40,21,217,18,150,157,438,7392,346,174,2500,825,7830
67,45,839,1107,1009,15696,2639,641,2162,320,2504,10687,7827,147678,30100,5689,22705,16705,155505
67,50,2,0,0,0,0,0,0,2,14,0,0,0,0,0,0,0,0
67,54,389,441,290,7915,902,341,360,156,1091,4251,2186,63790,8336,2389,2963,8205,65976
67,55,23,0,0,0,0,0,0,13,67,0,0,0,0,0,0,0,0
67,56,147,63,243,2331,295,81,202,68,426,473,1770,20788,3003,653,1904,2574,22558
67,57,90,123,37,2260,196,32,73,35,273,896,232,17852,1886,235,569,2297,18084
67,58,297,267,114,5592,843,64,87,107,888,2199,644,44834,8032,501,720,5706,45478
67,59,10,2,16,54,13,1,0,6,31,14,56,323,42,5,0,70,379
67,60,9,0,0,0,0,0,0,6,29,0,0,0,0,0,0,0,0
67,122,25,0,0,0,0,0,0,1,43,0,0,0,0,0,0,0,0
68,39,98,0,0,0,0,0,0,11,204,0,0,0,0,0,0,0,0
68,40,88,45,173,760,83,63,191,25,218,425,1163,6436,761,615,1960,933,7599
68,44,232,414,720,6971,1377,394,624,81,622,3191,3987,44078,11293,2833,5631,7691,48065
68,51,91,72,71,1337,127,68,427,27,239,704,583,11839,1125,636,4194,1408,12422
68,57,2842,3644,3805,79901,16645,882,2277,525,6632,23470,20184,552237,108665,4848,15886,83706,572421
68,58,9,5,8,172,22,15,6,5,28,5,30,865,156,90,36,180,895
68,59,10,0,0,0,0,0,0,6,30,0,0,0,0,0,0,0,0
68,60,6,0,0,0,0,0,0,3,20,0,0,0,0,0,0,0,0
68,61,18,0,0,0,0,0,0,9,57,0,0,0,0,0,0,0,0
68,63,7,0,0,0,0,0,0,2,14,0,0,0,0,0,0,0,0
68,114,30,0,0,0,0,0,0,7,69,0,0,0,0,0,0,0,0
69,39,60,44,212,723,55,125,224,14,182,412,1704,6266,503,954,2315,935,7970
69,40,125,65,563,1607,114,178,262,45,286,494,3079,11193,722,1411,2207,2170,14272
69,44,2,0,0,0,0,0,0,1,10,0,0,0,0,0,0,0,0
69,45,171,120,159,3053,428,156,233,71,548,998,1377,25285,4438,1198,2171,3212,26662
69,46,5,0,0,0,0,0,0,2,11,0,0,0,0,0,0,0,0
69,50,244,133,135,4321,302,125,479,91,686,1200,1117,35890,2824,631,4718,4456,37007
69,51,1,0,0,0,0,0,0,1,7,0,0,0,0,0,0,0,0
69,56,1897,1441,4561,54264,5360,513,1824,434,4508,8557,18724,377597,43592,3017,12831,58825,396321
69,57,3374,1746,5510,94664,5453,945,4548,568,8605,10509,29373,644225,40463,4428,33494,100174,673598
69,58,6,10,1,214,91,0,0,4,24,83,7,2067,690,0,0,215,2074
69,59,6,0,0,0,0,0,0,2,12,0,0,0,0,0,0,0,0
69,60,2,0,0,0,0,0,0,2,12,0,0,0,0,0,0,0,0
69,62,4,0,0,0,0,0,0,2,11,0,0,0,0,0,0,0,0
69,110,9,0,0,0,0,0,0,1,15,0,0,0,0,0,0,0,0
69,112,8,0,0,0,0,0,0,1,16,0,0,0,0,0,0,0,0
69,117,9,0,0,0,0,0,0,1,22,0,0,0,0,0,0,0,0
69,119,230,200,8817,2544,241,126,464,15,425,396,39253,7321,661,281,1633,11361,46574
69,126,14,0,0,0,0,0,0,1,27,0,0,0,0,0,0,0,0
70,44,1,0,0,0,0,0,0,1,4,0,0,0,0,0,0,0,0
70,50,16,7,0,104,12,2,5,10,58,70,0,1519,124,33,46,104,1519
70,51,35,4,14,597,15,12,200,12,110,40,88,6105,201,104,2362,611,6193
70,55,7030,8507,15066,223008,21736,6492,5941,1864,17300,41914,63976,1377465,150561,34623,32882,238074,1441441
70,56,493,432,308,11440,1908,206,321,193,1327,3138,1866,88174,18227,1249,2665,11748,90040
70,57,5,0,0,0,0,0,0,2,10,0,0,0,0,0,0,0,0
70,58,19,0,0,0,0,0,0,10,64,0,0,0,0,0,0,0,0
70,114,12,0,0,0,0,0,0,1,40,0,0,0,0,0,0,0,0
70,122,1,0,0,0,0,0,0,1,3,0,0,0,0,0,0,0,0
70,126,10,0,0,0,0,0,0,2,17,0,0,0,0,0,0,0,0
71,45,2,0,0,0,0,0,0,1,4,0,0,0,0,0,0,0,0
71,46,39,10,61,302,41,25,40,18,107,104,510,2538,467,210,397,363,3048
71,47,10,0,0,0,0,0,0,2,20,0,0,0,0,0,0,0,0
71,48,252,412,182,5596,1353,212,1384,45,608,3988,1390,49313,12103,1130,15038,5778,50703
71,50,11,2,2,179,0,0,16,4,28,10,14,1902,0,0,207,181,1916
71,51,22,10,4,274,2,2,37,8,70,114,48,2807,16,8,398,278,2855
71,54,3361,5451,5186,109892,19232,767,2555,588,7779,32803,24570,729136,143863,3892,16963,115078,753706
71,55,42,60,7,1006,199,24,12,20,114,467,15,6951,1830,104,65,1013,6966
71,58,23,0,0,0,0,0,0,10,81,0,0,0,0,0,0,0,0
71,60,7,0,0,0,0,0,0,2,19,0,0,0,0,0,0,0,0
71,61,1,0,0,0,0,0,0,1,6,0,0,0,0,0,0,0,0
71,124,21,0,0,0,0,0,0,2,39,0,0,0,0,0,0,0,0
71,126,25,33,932,244,41,7,24,6,46,48,2326,485,122,9,28,1176,2811
72,46,212,92,260,3210,333,167,805,84,611,885,1991,27036,3410,1219,8528,3470,29027
72,47,6,0,0,0,0,0,0,2,12,0,0,0,0,0,0,0,0
72,53,791,214,533,17147,896,187,460,229,2053,1600,3696,135722,7314,1157,3532,17680,139418
72,54,1635,1404,3369,54036,5751,577,791,324,4202,8348,15687,361980,39972,2843,5160,57405,377667
72,57,1,0,0,0,0,0,0,1,6,0,0,0,0,0,0,0,0
72,59,24,19,7,512,210,12,0,17,107,207,49,5095,2479,100,0,519,5144
72,60,7,0,0,0,0,0,0,4,26,0,0,0,0,0,0,0,0
72,111,5,0,0,0,0,0,0,1,10,0,0,0,0,0,0,0,0
72,127,18,0,0,0,0,0,0,1,36,0,0,0,0,0,0,0,0
73,45,7,0,0,0,0,0,0,4,16,0,0,0,0,0,0,0,0
73,46,2413,1675,8406,70779,4530,2125,4974,553,6124,11159,43899,340631,31460,10202,44619,79185,384530
73,47,46,58,39,869,115,15,112,10,120,478,138,6718,1093,66,1086,908,6856
73,52,2275,2824,1212,59545,3417,379,1391,329,5663,11763,7835,428387,26607,1745,10548,60757,436222
73,55,2,0,0,0,0,0,0,2,4,0,0,0,0,0,0,0,0
73,56,4,0,0,0,0,0,0,2,12,0,0,0,0,0,0,0,0
73,57,2,0,0,0,0,0,0,2,7,0,0,0,0,0,0,0,0
73,58,6,0,0,0,0,0,0,1,12,0,0,0,0,0,0,0,0
73,59,35,0,0,0,0,0,0,20,123,0,0,0,0,0,0,0,0
73,60,20,16,0,294,118,0,0,10,68,214,0,3003,1520,0,0,294,3003
73,110,85,84,1529,1636,279,207,67,6,208,114,3036,3143,458,358,194,3165,6179
74,45,760,475,1950,14972,1603,887,1595,243,1923,4263,11944,103396,13650,5881,16530,16922,115340
74,46,2899,2716,5792,71064,10093,2041,4782,411,7001,18386,31877,501560,78328,10932,36345,76856,533437
74,47,93,9,58,965,70,20,35,26,195,39,438,7757,705,100,274,1023,8195
74,48,38,0,0,0,0,0,0,11,107,0,0,0,0,0,0,0,0
74,50,1,0,0,0,0,0,0,1,4,0,0,0,0,0,0,0,0
74,51,265,331,397,5800,985,370,508,70,705,2802,2752,43655,7542,2270,5213,6197,46407
74,55,3,0,0,0,0,0,0,3,12,0,0,0,0,0,0,0,0
74,56,1,0,0,0,0,0,0,1,4,0,0,0,0,0,0,0,0
74,58,10,0,0,0,0,0,0,3,20,0,0,0,0,0,0,0,0
74,59,79,8,801,414,153,20,15,22,197,35,1294,3905,2031,38,24,1215,5199
74,60,68,0,0,0,0,0,0,20,165,0,0,0,0,0,0,0,0
74,118,4,0,0,0,0,0,0,4,20,0,0,0,0,0,0,0,0
75,45,10,29,56,300,18,13,37,6,31,262,455,2388,136,87,452,356,2843
75,46,59,12,34,931,36,37,28,14,123,52,184,7406,295,330,225,965,7590
75,47,389,218,487,7268,1320,189,529,75,947,1608,3412,56826,10477,875,5049,7755,60238
75,51,99,12,21,1776,124,22,32,26,235,55,125,12042,1075,132,215,1797,12167
75,52,448,65,262,10689,233,30,104,94,1056,331,1507,73774,1919,213,697,10951,75281
75,53,5,0,0,0,0,0,0,3,16,0,0,0,0,0,0,0,0
75,54,4,0,0,0,0,0,0,1,8,0,0,0,0,0,0,0,0
75,58,1,0,0,0,0,0,0,1,5,0,0,0,0,0,0,0,0
75,59,22,25,36,394,134,14,7,10,63,157,99,2960,1541,30,11,430,3059
75,60,5,0,0,0,0,0,0,3,18,0,0,0,0,0,0,0,0
75,109,16,0,0,0,0,0,0,1,23,0,0,0,0,0,0,0,0
75,120,6,0,0,0,0,0,0,1,12,0,0,0,0,0,0,0,0
76,46,13,1,15,29,0,0,0,5,30,6,94,211,0,0,0,44,305
76,47,424,316,955,11611,812,143,624,94,961,2366,4814,84150,7141,916,3574,12566,88964
76,48,96,10,78,1898,81,22,20,30,234,133,306,13798,667,62,148,1976,14104
76,51,2039,913,4945,58415,5778,649,1726,333,5080,5662,21557,381682,36415,2361,10979,63360,403239
76,52,1,0,0,0,0,0,0,1,4,0,0,0,0,0,0,0,0
76,53,8,0,0,0,0,0,0,2,16,0,0,0,0,0,0,0,0
76,125,18,0,0,0,0,0,0,1,39,0,0,0,0,0,0,0,0
77,46,76,43,62,1211,172,7,88,22,174,392,502,11515,1917,35,862,1273,12017
77,47,46,0,5,375,26,5,12,17,106,0,41,4084,249,25,124,380,4125
77,50,1759,873,3036,51835,2958,410,2602,261,3996,4377,11886,323011,17769,1683,10700,54871,334897
77,51,441,120,179,10106,342,49,197,133,1107,843,1464,78431,2997,272,1586,10285,79895
77,53,5,0,0,0,0,0,0,4,12,0,0,0,0,0,0,0,0
77,108,5,0,0,0,0,0,0,1,13,0,0,0,0,0,0,0,0
77,113,21,0,0,0,0,0,0,1,49,0,0,0,0,0,0,0,0
78,41,4,0,0,0,0,0,0,1,11,0,0,0,0,0,0,0,0
78,42,217,0,0,0,0,0,0,16,457,0,0,0,0,0,0,0,0
78,45,141,0,0,0,0,0,0,40,329,0,0,0,0,0,0,0,0
78,47,12,4,20,111,9,0,7,5,24,42,347,1063,86,0,84,131,1410
78,50,6,0,0,0,0,0,0,2,11,0,0,0,0,0,0,0,0
78,52,3,0,0,0,0,0,0,1,15,0,0,0,0,0,0,0,0
78,53,26,7,274,701,61,41,9,4,56,7,468,1431,216,53,15,975,1899
78,112,6,0,0,0,0,0,0,1,22,0,0,0,0,0,0,0,0
78,113,73,75,3226,1208,156,109,178,6,143,169,6503,3859,559,163,295,4434,10362
78,114,1,0,0,0,0,0,0,1,6,0,0,0,0,0,0,0,0
78,115,86,0,0,0,0,0,0,4,202,0,0,0,0,0,0,0,0
78,119,13,0,0,0,0,0,0,1,56,0,0,0,0,0,0,0,0
78,123,27,92,425,481,8,136,46,6,49,188,1594,1581,27,324,144,906,3175
79,41,59,19,91,1014,71,48,53,22,131,174,568,4726,418,240,508,1105,5294
79,42,90,30,241,2879,120,181,103,27,205,111,1075,8866,548,584,755,3120,9941
79,45,107,0,0,0,0,0,0,40,230,0,0,0,0,0,0,0,0
79,46,2,0,0,0,0,0,0,1,4,0,0,0,0,0,0,0,0
79,47,1,0,0,0,0,0,0,1,4,0,0,0,0,0,0,0,0
79,49,105,38,379,1506,230,100,141,36,271,163,1090,6638,1607,309,473,1885,7728
79,50,47,39,35,922,231,34,19,18,127,134,118,4017,1127,78,86,957,4135
79,51,2,0,0,0,0,0,0,1,4,0,0,0,0,0,0,0,0
79,52,13,0,0,0,0,0,0,3,26,0,0,0,0,0,0,0,0
79,107,1,0,0,0,0,0,0,1,2,0,0,0,0,0,0,0,0
79,108,11,0,0,0,0,0,0,1,25,0,0,0,0,0,0,0,0
79,110,11,0,0,0,0,0,0,5,26,0,0,0,0,0,0,0,0
80,45,349,135,355,6217,445,108,276,92,911,1054,2628,46309,3676,660,2230,6572,48937
80,46,291,126,317,5557,249,70,180,85,765,944,2402,43529,2415,529,1719,5874,45931
80,48,152,57,74,2537,322,11,285,65,410,524,477,21499,3485,59,1975,2611,21976
80,49,34,14,23,190,65,3,7,14,82,80,64,1448,559,9,53,213,1512
80,115,5,0,0,0,0,0,0,1,9,0,0,0,0,0,0,0,0
80,125,6,0,0,0,0,0,0,1,34,0,0,0,0,0,0,0,0
81,41,80,52,266,1505,128,90,115,16,225,314,1722,6524,604,352,1038,1771,8246
81,45,170,32,212,3314,172,80,66,56,513,234,1138,27824,1613,407,491,3526,28962
81,47,47,72,3,556,136,6,0,18,125,629,28,4921,1404,37,0,559,4949
81,49,15,2,11,112,13,1,8,7,37,14,74,941,180,4,50,123,1015
81,108,15,0,0,0,0,0,0,1,23,0,0,0,0,0,0,0,0
81,111,10,0,0,0,0,0,0,3,26,0,0,0,0,0,0,0,0
81,115,7,0,0,0,0,0,0,1,15,0,0,0,0,0,0,0,0
81,116,6,0,0,0,0,0,0,1,14,0,0,0,0,0,0,0,0
81,118,3,0,0,0,0,0,0,2,11,0,0,0,0,0,0,0,0
81,120,6,0,0,0,0,0,0,1,12,0,0,0,0,0,0,0,0
82,41,64,0,0,0,0,0,0,8,183,0,0,0,0,0,0,0,0
82,44,2,0,0,0,0,0,0,1,10,0,0,0,0,0,0,0,0
82,45,86,0,0,0,0,0,0,11,249,0,0,0,0,0,0,0,0
82,46,609,235,333,12913,880,248,308,155,1635,1427,2287,93235,7865,1582,2407,13246,95522
82,47,5,0,0,0,0,0,0,1,9,0,0,0,0,0,0,0,0
82,48,112,0,0,0,0,0,0,4,327,0,0,0,0,0,0,0,0
82,115,35,0,0,0,0,0,0,2,65,0,0,0,0,0,0,0,0
82,118,98,0,0,0,0,0,0,3,305,0,0,0,0,0,0,0,0
83,40,7,0,3,53,13,0,0,5,22,0,19,441,146,0,0,56,460
83,41,80,70,415,2673,199,234,73,32,199,446,1916,10491,1148,805,546,3088,12407
83,48,6,0,0,0,0,0,0,1,11,0,0,0,0,0,0,0,0
83,50,10,0,0,0,0,0,0,1,20,0,0,0,0,0,0,0,0
83,118,7,0,0,0,0,0,0,1,17,0,0,0,0,0,0,0,0
84,41,6,0,0,0,0,0,0,5,23,0,0,0,0,0,0,0,0
84,44,3,0,0,0,0,0,0,2,6,0,0,0,0,0,0,0,0
84,45,5,7,11,146,8,8,0,4,15,14,57,709,32,46,0,157,766
84,50,98,0,0,0,0,0,0,8,238,0,0,0,0,0,0,0,0
84,109,33,0,0,0,0,0,0,3,68,0,0,0,0,0,0,0,0
84,112,6,0,0,0,0,0,0,1,15,0,0,0,0,0,0,0,0
84,117,1,0,0,0,0,0,0,1,4,0,0,0,0,0,0,0,0
84,121,3,0,0,0,0,0,0,1,8,0,0,0,0,0,0,0,0
85,41,77,15,132,1480,109,82,70,40,207,139,918,6959,724,556,627,1612,7877
85,43,271,0,0,0,0,0,0,6,812,0,0,0,0,0,0,0,0
85,44,151,215,1130,6857,587,558,184,65,352,540,3115,18188,2117,1266,393,7987,21303
85,46,7,0,0,0,0,0,0,2,14,0,0,0,0,0,0,0,0
85,108,267,480,7508,8887,1260,650,447,41,631,709,14886,16106,2188,837,753,16395,30992
85,109,11,0,0,0,0,0,0,3,28,0,0,0,0,0,0,0,0
85,117,65,86,2628,1246,104,84,157,6,109,99,4993,2833,271,169,216,3874,7826
85,118,1,0,0,0,0,0,0,1,2,0,0,0,0,0,0,0,0
86,40,128,115,261,2520,199,238,287,39,306,1046,1532,15990,1323,1321,2610,2781,17522
86,43,55,21,32,662,56,22,53,19,115,141,156,4915,525,281,417,694,5071
86,45,3,0,0,0,0,0,0,1,6,0,0,0,0,0,0,0,0
86,118,4,0,0,0,0,0,0,1,9,0,0,0,0,0,0,0,0
86,125,11,48,403,291,27,89,22,3,17,76,593,791,38,391,24,694,1384
87,43,11,0,0,0,0,0,0,7,28,0,0,0,0,0,0,0,0
87,45,1,0,0,0,0,0,0,1,4,0,0,0,0,0,0,0,0
87,120,11,0,0,0,0,0,0,1,24,0,0,0,0,0,0,0,0
87,125,25,0,0,0,0,0,0,2,45,0,0,0,0,0,0,0,0
88,43,8,0,0,0,0,0,0,3,18,0,0,0,0,0,0,0,0
88,109,17,0,0,0,0,0,0,2,50,0,0,0,0,0,0,0,0
89,41,139,33,233,3386,271,50,28,20,296,173,1126,19519,2133,183,197,3619,20645
89,42,20,21,6,452,31,18,14,7,56,185,41,3391,232,127,160,458,3432
89,43,678,539,945,23347,3573,521,414,125,1622,3572,4031,119746,28298,2239,2280,24292,123777
90,41,74,0,0,0,0,0,0,22,170,0,0,0,0,0,0,0,0
90,42,3,0,0,0,0,0,0,1,6,0,0,0,0,0,0,0,0
90,109,6,0,0,0,0,0,0,2,10,0,0,0,0,0,0,0,0
90,113,6,0,0,0,0,0,0,1,13,0,0,0,0,0,0,0,0
90,124,3,0,0,0,0,0,0,1,5,0,0,0,0,0,0,0,0
91,40,392,252,474,12802,875,272,42,55,841,1658,1856,76645,6324,1433,265,13276,78501
91,41,121,110,60,2590,321,154,28,46,319,452,413,11986,1520,504,70,2650,12399
91,42,4,0,0,0,0,0,0,4,12,0,0,0,0,0,0,0,0
91,123,45,0,0,0,0,0,0,4,93,0,0,0,0,0,0,0,0
91,124,9,0,0,0,0,0,0,4,28,0,0,0,0,0,0,0,0
92,40,671,700,1367,49438,3649,1410,313,55,1817,2880,4145,221223,16482,3956,1034,50805,225368
92,41,180,246,113,9282,2031,593,230,46,496,871,671,39026,8635,1815,588,9395,39697
92,114,20,0,0,0,0,0,0,2,39,0,0,0,0,0,0,0,0
92,118,5,0,0,0,0,0,0,1,13,0,0,0,0,0,0,0,0
92,122,3,0,0,0,0,0,0,1,6,0,0,0,0,0,0,0,0
92,123,1,0,0,0,0,0,0,1,5,0,0,0,0,0,0,0,0
92,125,6,0,0,0,0,0,0,1,12,0,0,0,0,0,0,0,0
93,39,1004,1324,4900,79944,4452,2616,569,279,2262,4796,12252,300396,20366,9184,1788,84844,312648
93,40,2252,5373,12791,197514,10941,4354,1227,314,4899,26692,37679,734671,57213,14799,3334,210305,772350
93,41,342,253,632,11044,1373,589,95,108,797,1742,1646,52545,9291,2548,417,11676,54191
93,109,33,6,330,285,46,59,22,4,69,8,639,689,84,335,22,615,1328
93,113,2,0,0,0,0,0,0,1,4,0,0,0,0,0,0,0,0
93,114,89,255,4770,3025,324,166,223,11,179,479,10621,5345,850,330,284,7795,15966
93,121,125,0,0,0,0,0,0,6,246,0,0,0,0,0,0,0,0
94,39,6735,9497,25245,643551,33128,17603,3433,2282,15927,33649,66856,1993298,111253,48551,8937,668796,2060154
94,40,759,745,8802,76272,3789,3135,369,314,1821,1939,14970,160914,9023,6951,678,85074,175884
94,122,9,0,0,0,0,0,0,2,20,0,0,0,0,0,0,0,0
94,123,3,0,0,0,0,0,0,1,7,0,0,0,0,0,0,0,0
95,39,186,213,173,14705,859,329,59,90,464,866,460,50403,3556,1215,165,14878,50863
95,40,59,39,251,2013,161,164,25,18,168,80,778,7378,627,391,29,2264,8156
95,120,16,0,0,0,0,0,0,3,26,0,0,0,0,0,0,0,0
95,121,4,0,0,0,0,0,0,2,10,0,0,0,0,0,0,0,0
95,122,9,0,0,0,0,0,0,2,19,0,0,0,0,0,0,0,0
95,126,66,127,2564,1613,120,152,421,6,163,172,3963,2341,271,174,456,4177,6304
95,127,9,0,91,47,4,4,2,5,20,0,299,136,13,4,2,138,435
96,38,524,6,8,663,24,5,2,14,1070,34,18,4322,175,19,12,671,4340
96,39,1890,2518,10610,109369,11627,3909,952,357,4477,10551,28026,452150,51979,12276,3317,119979,480176
96,40,10,0,0,0,0,0,0,4,28,0,0,0,0,0,0,0,0
96,121,2,0,0,0,0,0,0,1,9,0,0,0,0,0,0,0,0
96,126,11,0,0,0,0,0,0,2,25,0,0,0,0,0,0,0,0
97,37,50,20,28,1337,78,18,7,23,135,79,40,3546,331,33,8,1365,3586
97,38,1897,2602,2333,91153,5226,1906,437,403,4333,15878,7958,509429,31727,7723,1964,93486,517387
97,39,80,46,60,2737,230,101,5,31,194,229,290,15456,1542,456,31,2797,15746
97,121,203,0,0,0,0,0,0,12,351,0,0,0,0,0,0,0,0
97,123,6,0,0,0,0,0,0,2,12,0,0,0,0,0,0,0,0
97,126,55,28,1420,2274,42,2,114,13,106,50,2581,2643,84,6,144,3694,5224
98,37,64,42,653,4074,214,95,66,30,152,174,1390,10711,639,197,129,4727,12101
98,38,10,0,0,0,0,0,0,5,24,0,0,0,0,0,0,0,0
98,114,3,0,0,0,0,0,0,3,7,0,0,0,0,0,0,0,0
98,119,2,0,0,0,0,0,0,2,8,0,0,0,0,0,0,0,0
98,120,7,0,0,0,0,0,0,1,14,0,0,0,0,0,0,0,0
98,121,363,699,17801,10575,1120,572,867,78,766,1399,31416,24380,3067,1945,1366,28376,55796
98,122,51,9,1116,427,62,19,24,19,107,24,2299,918,244,40,28,1543,3217
98,123,10,0,0,0,0,0,0,2,18,0,0,0,0,0,0,0,0
98,124,13,0,0,0,0,0,0,1,29,0,0,0,0,0,0,0,0
98,127,20,0,0,0,0,0,0,3,44,0,0,0,0,0,0,0,0
99,36,23,10,14,446,46,17,2,13,57,49,268,1960,177,56,2,460,2228
99,37,11,0,0,0,0,0,0,4,24,0,0,0,0,0,0,0,0
99,38,1,0,0,0,0,0,0,1,2,0,0,0,0,0,0,0,0
99,39,2,0,0,0,0,0,0,1,4,0,0,0,0,0,0,0,0
99,107,2,0,0,0,0,0,0,1,6,0,0,0,0,0,0,0,0
99,108,25,42,756,660,100,37,43,11,60,78,1454,1352,206,62,162,1416,2806
99,110,2,0,0,0,0,0,0,1,4,0,0,0,0,0,0,0,0
99,122,61,0,0,0,0,0,0,9,157,0,0,0,0,0,0,0,0
100,36,41,7,32,462,36,20,3,17,97,47,170,3134,193,81,3,494,3304
100,37,21,6,12,490,38,3,0,10,67,45,32,3682,507,14,0,502,3714
100,107,8,0,0,0,0,0,0,2,16,0,0,0,0,0,0,0,0
100,114,356,125,6516,2630,458,359,119,22,783,454,9341,4785,985,622,239,9146,14126
100,116,7,0,0,0,0,0,0,1,14,0,0,0,0,0,0,0,0
100,126,22,0,0,0,0,0,0,3,73,0,0,0,0,0,0,0,0
101,35,172,226,87,4457,928,201,177,57,423,1043,561,27733,4464,1105,1137,4544,28294
101,36,12,0,0,0,0,0,0,6,33,0,0,0,0,0,0,0,0
101,37,18,6,2,380,59,1,0,8,46,84,12,3150,496,3,0,382,3162
101,113,20,0,0,0,0,0,0,2,49,0,0,0,0,0,0,0,0
102,34,12,0,0,98,2,0,3,5,26,0,0,864,12,0,17,98,864
102,35,2,0,0,0,0,0,0,1,6,0,0,0,0,0,0,0,0
102,115,4,0,0,0,0,0,0,1,8,0,0,0,0,0,0,0,0
102,121,15,8,172,111,33,0,13,7,32,22,365,403,96,0,18,283,768
103,34,4,0,0,0,0,0,0,1,8,0,0,0,0,0,0,0,0
103,105,6,0,0,0,0,0,0,2,12,0,0,0,0,0,0,0,0
103,107,8,0,0,0,0,0,0,1,19,0,0,0,0,0,0,0,0
103,116,34,0,0,0,0,0,0,5,63,0,0,0,0,0,0,0,0
103,117,53,0,0,0,0,0,0,2,121,0,0,0,0,0,0,0,0
103,120,7,0,0,0,0,0,0,2,20,0,0,0,0,0,0,0,0
104,112,1,0,0,0,0,0,0,1,4,0,0,0,0,0,0,0,0
104,116,162,135,4537,1966,339,136,123,17,626,237,7836,4064,819,500,173,6503,11900
105,116,2,0,0,0,0,0,0,1,4,0,0,0,0,0,0,0,0
105,121,17,0,0,0,0,0,0,4,34,0,0,0,0,0,0,0,0
106,108,60,0,0,0,0,0,0,1,120,0,0,0,0,0,0,0,0
106,115,6,0,0,0,0,0,0,1,20,0,0,0,0,0,0,0,0
107,111,5,0,0,0,0,0,0,1,10,0,0,0,0,0,0,0,0
107,114,7,0,0,0,0,0,0,1,14,0,0,0,0,0,0,0,0
109,113,1,0,0,0,0,0,0,1,2,0,0,0,0,0,0,0,0
111,113,25,0,0,0,0,0,0,3,50,0,0,0,0,0,0,0,0
112,113,40,113,2740,918,146,36,81,5,76,161,3844,1228,234,41,83,3658,5072
